Date,Ref No,Trans Description,Setl No,Buy/Cr,Sell/Dr,Balance
ISIN: INE423A01024,ISIN Name: ADANI ENTERPR RS.1/-,,,,,
2024-03-01 00:00:00,,Opening Balance,,,,0.0
2024-04-24 00:00:00,109305,CREDIT On Market 1208870000010189,,1.0,,1.0
2024-05-27 00:00:00,597026,CREDIT On Market 1208870000010189,,1.0,,2.0
2024-06-04 00:00:00,193041,CREDIT On Market 1208870000010189,,1.0,,3.0
2024-06-05 00:00:00,1268627,CREDIT On Market 1100001100021102,1211232024104.0,2.0,,5.0
2024-06-05 00:00:00,1268627,DEBIT On Market 1100001100021102,1211232024104.0,,2.0,3.0
2024-06-06 00:00:00,434355,CREDIT On Market 1208870000010189,,2.0,,5.0
2024-06-21 00:00:00,38445915,DEBIT On Market 1100001100021102,1211232024116.0,,1.0,4.0
2024-06-24 00:00:00,38445915,DEBIT On Market 1100001100021102,1211232024116.0,,1.0,3.0
2024-06-24 00:00:00,38445915,CREDIT On Market 1100001100021102,1211232024116.0,1.0,,4.0
2024-07-30 00:00:00,504476,CREDIT On Market 1208870000010189,,1.0,,5.0
2024-08-02 00:00:00,307003,CREDIT On Market 1208870000010189,,2.0,,7.0
2024-08-12 00:00:00,43510003,DEBIT On Market 1100001100021102,1211232024151.0,,2.0,5.0
2024-08-13 00:00:00,43510003,DEBIT On Market 1100001100021102,1211232024151.0,,2.0,3.0
2024-08-13 00:00:00,43510003,CREDIT On Market 1100001100021102,1211232024151.0,2.0,,5.0
2024-11-27 00:00:00,,Closing Balance,,,,3.0
ISIN: INE364U01010,ISIN Name: ADANI GREEN ENERG-EQ,,,,,
2024-03-01 00:00:00,,Opening Balance,,,,0.0
2024-04-24 00:00:00,109256,CREDIT On Market 1208870000010189,,2.0,,2.0
2024-06-05 00:00:00,770872,CREDIT On Market 1208870000010189,,1.0,,3.0
2024-06-06 00:00:00,434282,CREDIT On Market 1208870000010189,,2.0,,5.0
2024-06-19 00:00:00,33075097,DEBIT On Market 1100001100021102,1211232024114.0,,3.0,2.0
2024-06-20 00:00:00,33075097,DEBIT On Market 1100001100021102,1211232024114.0,,3.0,-1.0
2024-06-20 00:00:00,33075097,CREDIT On Market 1100001100021102,1211232024114.0,3.0,,2.0
2024-07-30 00:00:00,504294,CREDIT On Market 1208870000010189,,2.0,,4.0
2024-08-14 00:00:00,926053,CREDIT On Market 1208870000010189,,1.0,,5.0
2024-11-27 00:00:00,,Closing Balance,,,,5.0
ISIN: INE742F01042,ISIN Name: ADANI PORTS -EQ 2/-,,,,,
2024-03-01 00:00:00,,Opening Balance,,,,0.0
2024-04-24 00:00:00,109353,CREDIT On Market 1208870000010189,,2.0,,2.0
2024-06-25 00:00:00,337043,CREDIT On Market 1208870000010189,,1.0,,3.0
2024-07-30 00:00:00,19238822,DEBIT On Market 1100001100021102,1211232024142.0,,1.0,2.0
2024-07-31 00:00:00,19238822,DEBIT On Market 1100001100021102,1211232024142.0,,1.0,1.0
2024-07-31 00:00:00,19238822,CREDIT On Market 1100001100021102,1211232024142.0,1.0,,2.0
2024-08-01 00:00:00,481983,CREDIT On Market 1208870000010189,,1.0,,3.0
2024-08-02 00:00:00,514381,CREDIT On Market 1208870000010189,,1.0,,4.0
2024-11-27 00:00:00,,Closing Balance,,,,4.0
ISIN: INE814H01011,ISIN Name: ADANI POWER - EQ,,,,,
2024-03-01 00:00:00,,Opening Balance,,,,0.0
2024-06-07 00:00:00,419797,CREDIT On Market 1208870000010189,,2.0,,2.0
2024-06-24 00:00:00,716461,CREDIT On Market 1208870000010189,,3.0,,5.0
2024-06-27 00:00:00,215522,CREDIT On Market 1208870000010189,,2.0,,7.0
2024-07-08 00:00:00,71224412,DEBIT On Market 1100001100021102,1211232024127.0,,2.0,5.0
2024-07-09 00:00:00,71224412,DEBIT On Market 1100001100021102,1211232024127.0,,2.0,3.0
2024-07-09 00:00:00,71224412,CREDIT On Market 1100001100021102,1211232024127.0,2.0,,5.0
2024-07-31 00:00:00,291837,CREDIT On Market 1208870000010189,,5.0,,10.0
2024-08-01 00:00:00,24837608,DEBIT On Market 1100001100021102,1211232024144.0,,5.0,5.0
2024-08-02 00:00:00,24837608,DEBIT On Market 1100001100021102,1211232024144.0,,5.0,0.0
2024-08-02 00:00:00,24837608,CREDIT On Market 1100001100021102,1211232024144.0,5.0,,5.0
2024-11-27 00:00:00,,Closing Balance,,,,5.0
ISIN: INE399L01023,ISIN Name: ADANI TOTAL GA-EQ1/-,,,,,
2024-03-01 00:00:00,,Opening Balance,,,,0.0
2024-07-30 00:00:00,504382,CREDIT On Market 1208870000010189,,3.0,,3.0
2024-11-27 00:00:00,,Closing Balance,,,,3.0
ISIN: INE699H01024,ISIN Name: ADANI WILMAR-EQ1/-,,,,,
2024-03-01 00:00:00,,Opening Balance,,,,0.0
2024-07-09 00:00:00,157647,CREDIT On Market 1208870000010189,,10.0,,10.0
2024-07-18 00:00:00,836509,CREDIT On Market 1208870000010189,,5.0,,15.0
2024-07-25 00:00:00,9133312,DEBIT On Market 1100001100021102,1211232024139.0,,5.0,10.0
2024-07-26 00:00:00,9133312,CREDIT On Market 1100001100021102,1211232024139.0,5.0,,15.0
2024-07-26 00:00:00,9133312,DEBIT On Market 1100001100021102,1211232024139.0,,5.0,10.0
2024-07-29 00:00:00,17285081,CREDIT On Market 1100001100021102,1211232024141.0,5.0,,15.0
2024-07-29 00:00:00,17285081,DEBIT On Market 1100001100021102,1211232024141.0,,5.0,10.0
2024-07-30 00:00:00,504742,CREDIT On Market 1208870000010189,,5.0,,15.0
2024-08-02 00:00:00,27769399,DEBIT On Market 1100001100021102,1211232024145.0,,5.0,10.0
2024-08-05 00:00:00,27769399,DEBIT On Market 1100001100021102,1211232024145.0,,5.0,5.0
2024-08-05 00:00:00,27769399,CREDIT On Market 1100001100021102,1211232024145.0,5.0,,10.0
2024-08-12 00:00:00,43698969,DEBIT On Market 1100001100021102,1211232024151.0,,7.0,3.0
2024-08-13 00:00:00,43698969,CREDIT On Market 1100001100021102,1211232024151.0,7.0,,10.0
2024-08-13 00:00:00,43698969,DEBIT On Market 1100001100021102,1211232024151.0,,7.0,3.0
2024-08-14 00:00:00,998825,CREDIT On Market 1208870000010189,,2.0,,5.0
2024-08-29 00:00:00,76161250,DEBIT On Market 1100001100021102,1211232024163.0,,5.0,0.0
2024-08-30 00:00:00,76161250,CREDIT On Market 1100001100021102,1211232024163.0,5.0,,5.0
2024-08-30 00:00:00,76161250,DEBIT On Market 1100001100021102,1211232024163.0,,5.0,0.0
2024-11-27 00:00:00,,Closing Balance,,,,0.0
ISIN: INE885A01032,ISIN Name: AMARA RAJA EQ 1/-,,,,,
2024-03-01 00:00:00,,Opening Balance,,,,0.0
2024-06-28 00:00:00,302257,CREDIT On Market 1208870000010189,,1.0,,1.0
2024-07-05 00:00:00,760642,CREDIT On Market 1208870000010189,,1.0,,2.0
2024-07-09 00:00:00,75481029,DEBIT On Market 1100001100021102,1211232024128.0,,1.0,1.0
2024-07-10 00:00:00,75481029,DEBIT On Market 1100001100021102,1211232024128.0,,1.0,0.0
2024-07-10 00:00:00,75481029,CREDIT On Market 1100001100021102,1211232024128.0,1.0,,1.0
2024-07-11 00:00:00,702393,CREDIT On Market 1208870000010189,,2.0,,3.0
2024-07-15 00:00:00,88613136,DEBIT On Market 1100001100021102,1211232024132.0,,2.0,1.0
2024-07-16 00:00:00,88613136,DEBIT On Market 1100001100021102,1211232024132.0,,2.0,-1.0
2024-07-16 00:00:00,88613136,CREDIT On Market 1100001100021102,1211232024132.0,2.0,,1.0
2024-11-27 00:00:00,,Closing Balance,,,,1.0
ISIN: INE079A01024,ISIN Name: AMBUJA CEMENTS EQ,,,,,
2024-03-01 00:00:00,,Opening Balance,,,,0.0
2024-06-18 00:00:00,412927,CREDIT On Market 1208870000010189,,10.0,,10.0
2024-06-19 00:00:00,33090192,DEBIT On Market 1100001100021102,1211232024114.0,,5.0,5.0
2024-06-20 00:00:00,33090192,CREDIT On Market 1100001100021102,1211232024114.0,5.0,,10.0
2024-06-20 00:00:00,33090192,DEBIT On Market 1100001100021102,1211232024114.0,,5.0,5.0
2024-07-10 00:00:00,79177940,DEBIT On Market 1100001100021102,1211232024129.0,,3.0,2.0
2024-07-11 00:00:00,79177940,CREDIT On Market 1100001100021102,1211232024129.0,3.0,,2.0
2024-07-30 00:00:00,503668,CREDIT On Market 1208870000010189,,5.0,,7.0
2024-08-01 00:00:00,24837624,DEBIT On Market 1100001100021102,1211232024144.0,,2.0,5.0
2024-08-02 00:00:00,24837624,CREDIT On Market 1100001100021102,1211232024144.0,2.0,,7.0
2024-08-02 00:00:00,24837624,DEBIT On Market 1100001100021102,1211232024144.0,,2.0,5.0
2024-11-27 00:00:00,,Closing Balance,,,,5.0
ISIN: INE208A01029,ISIN Name: ASHOK LEYLAND-RE.1/-,,,,,
2024-03-01 00:00:00,,Opening Balance,,,,0.0
2024-06-03 00:00:00,119351,CREDIT On Market 1208870000010189,,5.0,,5.0
2024-06-04 00:00:00,99508512,DEBIT On Market 1100001100021102,1211232024104.0,,3.0,2.0
2024-06-05 00:00:00,99508512,CREDIT On Market 1100001100021102,1211232024104.0,3.0,,5.0
2024-06-05 00:00:00,99508512,DEBIT On Market 1100001100021102,1211232024104.0,,3.0,2.0
2024-06-25 00:00:00,336971,CREDIT On Market 1208870000010189,,3.0,,5.0
2024-07-15 00:00:00,88620401,DEBIT On Market 1100001100021102,1211232024132.0,,3.0,2.0
2024-07-16 00:00:00,88620401,CREDIT On Market 1100001100021102,1211232024132.0,3.0,,5.0
2024-07-16 00:00:00,88620401,DEBIT On Market 1100001100021102,1211232024132.0,,3.0,2.0
2024-07-18 00:00:00,96669434,DEBIT On Market 1100001100021102,1211232024134.0,,1.0,1.0
2024-07-18 00:00:00,95416154,DEBIT On Market 1100001100021102,1211232024134.0,,2.0,-1.0
2024-07-18 00:00:00,836253,CREDIT On Market 1208870000010189,,3.0,,2.0
2024-07-19 00:00:00,95416154,CREDIT On Market 1100001100021102,1211232024134.0,2.0,,4.0
2024-07-19 00:00:00,95416154,DEBIT On Market 1100001100021102,1211232024134.0,,2.0,2.0
2024-07-19 00:00:00,96669434,CREDIT On Market 1100001100021102,1211232024134.0,1.0,,3.0
2024-07-19 00:00:00,96669434,DEBIT On Market 1100001100021102,1211232024134.0,,1.0,2.0
2024-07-30 00:00:00,503954,CREDIT On Market 1208870000010189,,3.0,,5.0
2024-11-27 00:00:00,,Closing Balance,,,,5.0
ISIN: INE021A01026,ISIN Name: ASIAN PAINTS EQ 1/-,,,,,
2024-03-01 00:00:00,,Opening Balance,,,,0.0
2024-03-27 00:00:00,778912,CREDIT On Market 1208870000010189,,3.0,,3.0
2024-06-20 00:00:00,34762789,DEBIT On Market 1100001100021102,1211232024115.0,,1.0,2.0
2024-06-21 00:00:00,34762789,CREDIT On Market 1100001100021102,1211232024115.0,1.0,,3.0
2024-06-21 00:00:00,34762789,DEBIT On Market 1100001100021102,1211232024115.0,,1.0,2.0
2024-07-18 00:00:00,94161092,DEBIT On Market 1100001100021102,1211232024134.0,,1.0,1.0
2024-07-19 00:00:00,94161092,CREDIT On Market 1100001100021102,1211232024134.0,1.0,,2.0
2024-07-19 00:00:00,94161092,DEBIT On Market 1100001100021102,1211232024134.0,,1.0,1.0
2024-08-01 00:00:00,815278,CREDIT On Market 1208870000010189,,1.0,,2.0
2024-08-13 00:00:00,602465,CREDIT On Market 1208870000010189,,1.0,,3.0
2024-11-27 00:00:00,,Closing Balance,,,,3.0
ISIN: INE238A01034,ISIN Name: AXIS BANK EQ,,,,,
2024-03-01 00:00:00,,Opening Balance,,,,0.0
2024-03-11 00:00:00,757297,CREDIT On Market 1208870000010189,,10.0,,10.0
2024-07-31 00:00:00,22020179,DEBIT On Market 1100001100021102,1211232024143.0,,5.0,5.0
2024-08-01 00:00:00,22020179,CREDIT On Market 1100001100021102,1211232024143.0,5.0,,10.0
2024-08-01 00:00:00,22020179,DEBIT On Market 1100001100021102,1211232024143.0,,5.0,5.0
2024-11-27 00:00:00,,Closing Balance,,,,5.0
ISIN: INE917I01010,ISIN Name: BAJAJ AUTO  - EQ,,,,,
2024-03-01 00:00:00,,Opening Balance,,,,0.0
2024-04-02 00:00:00,288274,CREDIT On Market 1208870000010189,,1.0,,1.0
2024-04-29 00:00:00,263023,CREDIT On Market 1208870000010189,,1.0,,2.0
2024-06-05 00:00:00,770930,CREDIT On Market 1208870000010189,,1.0,,3.0
2024-06-07 00:00:00,419869,CREDIT On Market 1208870000010189,,1.0,,4.0
2024-06-24 00:00:00,769506,CREDIT On Market 1208870000010189,,1.0,,5.0
2024-06-26 00:00:00,46665710,DEBIT On Market 1100001100021102,1211232024119.0,,2.0,3.0
2024-06-27 00:00:00,46665710,CREDIT On Market 1100001100021102,1211232024119.0,2.0,,5.0
2024-06-27 00:00:00,46665710,DEBIT On Market 1100001100021102,1211232024119.0,,2.0,3.0
2024-07-18 00:00:00,95033200,DEBIT On Market 1100001100021102,1211232024134.0,,2.0,1.0
2024-07-19 00:00:00,95033200,CREDIT On Market 1100001100021102,1211232024134.0,2.0,,1.0
2024-11-27 00:00:00,,Closing Balance,,,,1.0
ISIN: INE918I01026,ISIN Name: BAJAJ FINSERV-EQ1/-,,,,,
2024-03-01 00:00:00,,Opening Balance,,,,0.0
2024-03-27 00:00:00,588117,CREDIT On Market 1208870000010189,,2.0,,2.0
2024-11-27 00:00:00,,Closing Balance,,,,2.0
ISIN: INE171Z01026,ISIN Name: BHARAT DYNAMIC-EQ5/-,,,,,
2024-03-01 00:00:00,,Opening Balance,,,,0.0
2024-06-05 00:00:00,770819,CREDIT On Market 1208870000010189,,2.0,,2.0
2024-06-06 00:00:00,433772,CREDIT On Market 1208870000010189,,3.0,,5.0
2024-06-21 00:00:00,38332422,DEBIT On Market 1100001100021102,1211232024116.0,,3.0,2.0
2024-06-24 00:00:00,38332422,DEBIT On Market 1100001100021102,1211232024116.0,,3.0,-1.0
2024-06-24 00:00:00,38332422,CREDIT On Market 1100001100021102,1211232024116.0,3.0,,2.0
2024-06-26 00:00:00,970167,CREDIT On Market 1208870000010189,,1.0,,3.0
2024-07-18 00:00:00,94249615,DEBIT On Market 1100001100021102,1211232024134.0,,2.0,1.0
2024-07-19 00:00:00,94249615,CREDIT On Market 1100001100021102,1211232024134.0,2.0,,3.0
2024-07-19 00:00:00,94249615,DEBIT On Market 1100001100021102,1211232024134.0,,2.0,1.0
2024-07-23 00:00:00,978261,CREDIT On Market 1208870000010189,,1.0,,2.0
2024-07-31 00:00:00,291787,CREDIT On Market 1208870000010189,,1.0,,3.0
2024-08-16 00:00:00,793663,CREDIT On Market 1208870000010189,,1.0,,4.0
2024-09-05 00:00:00,886111,CREDIT On Market 1208870000010189,,1.0,,5.0
2024-11-27 00:00:00,,Closing Balance,,,,5.0
ISIN: INE263A01024,ISIN Name: BHARAT ELECTRONIC-EQ,,,,,
2024-03-01 00:00:00,,Opening Balance,,,,0.0
2024-05-27 00:00:00,302836,CREDIT On Market 1208870000010189,,5.0,,5.0
2024-06-06 00:00:00,434115,CREDIT On Market 1208870000010189,,5.0,,10.0
2024-07-05 00:00:00,973311,CREDIT On Market 1208870000010189,,5.0,,15.0
2024-11-27 00:00:00,,Closing Balance,,,,15.0
ISIN: INE257A01026,ISIN Name: BHARAT HEAVY - EQ 2,,,,,
2024-03-01 00:00:00,,Opening Balance,,,,0.0
2024-06-07 00:00:00,419236,CREDIT On Market 1208870000010189,,5.0,,5.0
2024-07-05 00:00:00,830212,CREDIT On Market 1208870000010189,,2.0,,7.0
2024-07-10 00:00:00,446544,CREDIT On Market 1208870000010189,,3.0,,10.0
2024-07-18 00:00:00,95451980,DEBIT On Market 1100001100021102,1211232024134.0,,5.0,5.0
2024-07-19 00:00:00,95451980,DEBIT On Market 1100001100021102,1211232024134.0,,5.0,0.0
2024-07-19 00:00:00,95451980,CREDIT On Market 1100001100021102,1211232024134.0,5.0,,5.0
2024-07-22 00:00:00,352215,CREDIT On Market 1208870000010189,,15.0,,20.0
2024-07-25 00:00:00,9141244,DEBIT On Market 1100001100021102,1211232024139.0,,10.0,10.0
2024-07-26 00:00:00,9141244,DEBIT On Market 1100001100021102,1211232024139.0,,10.0,0.0
2024-07-26 00:00:00,9141244,CREDIT On Market 1100001100021102,1211232024139.0,10.0,,10.0
2024-07-30 00:00:00,504039,CREDIT On Market 1208870000010189,,5.0,,15.0
2024-08-01 00:00:00,24796821,DEBIT On Market 1100001100021102,1211232024144.0,,5.0,10.0
2024-08-02 00:00:00,24796821,CREDIT On Market 1100001100021102,1211232024144.0,5.0,,15.0
2024-08-02 00:00:00,24796821,DEBIT On Market 1100001100021102,1211232024144.0,,5.0,10.0
2024-11-27 00:00:00,,Closing Balance,,,,10.0
ISIN: INE397D01024,ISIN Name: BHARTI AIRTEL-EQ 5,,,,,
2024-03-01 00:00:00,,Opening Balance,,,,0.0
2024-04-23 00:00:00,248531,CREDIT On Market 1208870000010189,,2.0,,2.0
2024-06-14 00:00:00,180588,CREDIT On Market 1208870000010189,,2.0,,4.0
2024-06-19 00:00:00,381211,CREDIT On Market 1208870000010189,,1.0,,5.0
2024-06-20 00:00:00,35003513,DEBIT On Market 1100001100021102,1211232024115.0,,3.0,2.0
2024-06-21 00:00:00,35003513,DEBIT On Market 1100001100021102,1211232024115.0,,3.0,-1.0
2024-06-21 00:00:00,35003513,CREDIT On Market 1100001100021102,1211232024115.0,3.0,,2.0
2024-06-24 00:00:00,741623,CREDIT On Market 1208870000010189,,3.0,,5.0
2024-07-23 00:00:00,4481506,DEBIT On Market 1100001100021102,1211232024137.0,,2.0,3.0
2024-07-24 00:00:00,4481506,CREDIT On Market 1100001100021102,1211232024137.0,2.0,,3.0
2024-11-27 00:00:00,,Closing Balance,,,,3.0
ISIN: INE376G01013,ISIN Name: BIOCON LTD EQ,,,,,
2024-03-01 00:00:00,,Opening Balance,,,,0.0
2024-09-03 00:00:00,486359,CREDIT On Market 1208870000010189,,10.0,,10.0
2024-11-27 00:00:00,,Closing Balance,,,,10.0
ISIN: INE029A01011,ISIN Name: BPCL EQUITY,,,,,
2024-03-01 00:00:00,,Opening Balance,,,,0.0
2024-04-22 00:00:00,770892,CREDIT On Market 1208870000010189,,2.0,,2.0
2024-06-05 00:00:00,1268606,DEBIT On Market 1100001100021102,1211232024104.0,,2.0,0.0
2024-06-05 00:00:00,1268606,CREDIT On Market 1100001100021102,1211232024104.0,2.0,,2.0
2024-06-11 00:00:00,943219,CREDIT On Market 1208870000010189,,3.0,,5.0
2024-07-05 00:00:00,558795,CREDIT Corporate Action TRANSFER_ON_LISTING_APPROVAL,,3.0,,8.0
2024-07-19 00:00:00,98103456,DEBIT On Market 1100001100021102,1211232024135.0,,3.0,5.0
2024-07-22 00:00:00,98103456,DEBIT On Market 1100001100021102,1211232024135.0,,3.0,2.0
2024-07-22 00:00:00,98103456,CREDIT On Market 1100001100021102,1211232024135.0,3.0,,5.0
2024-11-27 00:00:00,,Closing Balance,,,,3.0
ISIN: IN8029A01010,ISIN Name: BPCLUITYTLIST PEN,,,,,
2024-03-01 00:00:00,,Opening Balance,,,,0.0
2024-07-01 00:00:00,381687,CREDIT Corporate Action BONUS,,3.0,,3.0
2024-07-05 00:00:00,558795,DEBIT Corporate Action TRANSFER_ON_LISTING_APPROVAL,,,3.0,0.0
2024-11-27 00:00:00,,Closing Balance,,,,0.0
ISIN: INE216A01030,ISIN Name: BRITANNIA IND-EQ1/-,,,,,
2024-03-01 00:00:00,,Opening Balance,,,,0.0
2024-03-27 00:00:00,860757,CREDIT On Market 1208870000010189,,1.0,,1.0
2024-04-15 00:00:00,478646,CREDIT On Market 1208870000010189,,1.0,,2.0
2024-06-06 00:00:00,434026,CREDIT On Market 1208870000010189,,1.0,,3.0
2024-06-07 00:00:00,419177,CREDIT On Market 1208870000010189,,1.0,,4.0
2024-07-25 00:00:00,9139367,DEBIT On Market 1100001100021102,1211232024139.0,,2.0,2.0
2024-07-26 00:00:00,9139367,DEBIT On Market 1100001100021102,1211232024139.0,,2.0,0.0
2024-07-26 00:00:00,9139367,CREDIT On Market 1100001100021102,1211232024139.0,2.0,,2.0
2024-07-29 00:00:00,744805,CREDIT On Market 1208870000010189,,1.0,,3.0
2024-07-31 00:00:00,22311850,DEBIT On Market 1100001100021102,1211232024143.0,,1.0,2.0
2024-08-01 00:00:00,22311850,CREDIT On Market 1100001100021102,1211232024143.0,1.0,,3.0
2024-08-01 00:00:00,22311850,DEBIT On Market 1100001100021102,1211232024143.0,,1.0,2.0
2024-11-27 00:00:00,,Closing Balance,,,,2.0
ISIN: INE0LMW01024,ISIN Name: CELLO WORLD LTD-EQ,,,,,
2024-03-01 00:00:00,,Opening Balance,,,,0.0
2024-04-04 00:00:00,543767,CREDIT On Market 1208870000010189,,2.0,,2.0
2024-06-03 00:00:00,563773,CREDIT On Market 1208870000010189,,3.0,,5.0
2024-07-18 00:00:00,94148964,CREDIT On Market 1100001100021102,1211232024134.0,2.0,,7.0
2024-07-18 00:00:00,94148964,DEBIT On Market 1100001100021102,1211232024134.0,,2.0,5.0
2024-07-30 00:00:00,503768,CREDIT On Market 1208870000010189,,5.0,,10.0
2024-08-06 00:00:00,34354819,DEBIT On Market 1100001100021102,1211232024147.0,,4.0,6.0
2024-08-07 00:00:00,34354819,DEBIT On Market 1100001100021102,1211232024147.0,,4.0,2.0
2024-08-07 00:00:00,34354819,CREDIT On Market 1100001100021102,1211232024147.0,4.0,,6.0
2024-08-20 00:00:00,280829,CREDIT On Market 1208870000010189,,1.0,,7.0
2024-11-27 00:00:00,,Closing Balance,,,,7.0
ISIN: INE522F01014,ISIN Name: COAL INDIA LTD-EQ,,,,,
2024-03-01 00:00:00,,Opening Balance,,,,0.0
2024-03-27 00:00:00,798700,CREDIT On Market 1208870000010189,,2.0,,2.0
2024-06-07 00:00:00,419494,CREDIT On Market 1208870000010189,,3.0,,5.0
2024-11-27 00:00:00,,Closing Balance,,,,5.0
ISIN: INE704P01025,ISIN Name: COCHIN SHIP-EQ5/-,,,,,
2024-03-01 00:00:00,,Opening Balance,,,,0.0
2024-06-19 00:00:00,381268,CREDIT On Market 1208870000010189,,1.0,,3.0
2024-06-21 00:00:00,38386517,DEBIT On Market 1100001100021102,1211232024116.0,,1.0,2.0
2024-06-24 00:00:00,38386517,CREDIT On Market 1100001100021102,1211232024116.0,1.0,,3.0
2024-06-24 00:00:00,38386517,DEBIT On Market 1100001100021102,1211232024116.0,,1.0,2.0
2024-07-08 00:00:00,610279,CREDIT On Market 1208870000010189,,1.0,,3.0
2024-07-10 00:00:00,79168445,DEBIT On Market 1100001100021102,1211232024129.0,,1.0,2.0
2024-07-11 00:00:00,79168445,CREDIT On Market 1100001100021102,1211232024129.0,1.0,,3.0
2024-07-11 00:00:00,79168445,DEBIT On Market 1100001100021102,1211232024129.0,,1.0,2.0
2024-07-19 00:00:00,796162,CREDIT On Market 1208870000010189,,1.0,,3.0
2024-07-22 00:00:00,1030580,DEBIT On Market 1100001100021102,1211232024136.0,,1.0,2.0
2024-07-23 00:00:00,1030580,DEBIT On Market 1100001100021102,1211232024136.0,,1.0,1.0
2024-07-23 00:00:00,1030580,CREDIT On Market 1100001100021102,1211232024136.0,1.0,,2.0
2024-07-25 00:00:00,9157086,DEBIT On Market 1100001100021102,1211232024139.0,,1.0,1.0
2024-07-26 00:00:00,9157086,CREDIT On Market 1100001100021102,1211232024139.0,1.0,,2.0
2024-07-26 00:00:00,9157086,DEBIT On Market 1100001100021102,1211232024139.0,,1.0,1.0
2024-07-30 00:00:00,504828,CREDIT On Market 1208870000010189,,2.0,,3.0
2024-08-02 00:00:00,27766220,DEBIT On Market 1100001100021102,1211232024145.0,,1.0,2.0
2024-08-05 00:00:00,27766220,CREDIT On Market 1100001100021102,1211232024145.0,1.0,,3.0
2024-08-05 00:00:00,27766220,DEBIT On Market 1100001100021102,1211232024145.0,,1.0,2.0
2024-08-12 00:00:00,733415,CREDIT On Market 1208870000010189,,1.0,,3.0
2024-11-27 00:00:00,,Closing Balance,,,,3.0
ISIN: INE298A01020,ISIN Name: CUMMINS INDIA-RS 2/-,,,,,
2024-03-01 00:00:00,,Opening Balance,,,,0.0
2024-08-14 00:00:00,650007,CREDIT On Market 1208870000010189,,1.0,,1.0
2024-11-27 00:00:00,,Closing Balance,,,,1.0
ISIN: INE016A01026,ISIN Name: DABUR INDIA (RE.1/-),,,,,
2024-03-01 00:00:00,,Opening Balance,,,,0.0
2024-07-24 00:00:00,947911,CREDIT On Market 1208870000010189,,5.0,,5.0
2024-07-25 00:00:00,9172214,DEBIT On Market 1100001100021102,1211232024139.0,,3.0,2.0
2024-07-26 00:00:00,9172214,CREDIT On Market 1100001100021102,1211232024139.0,3.0,,5.0
2024-07-26 00:00:00,9172214,DEBIT On Market 1100001100021102,1211232024139.0,,3.0,2.0
2024-08-13 00:00:00,602432,CREDIT On Market 1208870000010189,,1.0,,3.0
2024-08-16 00:00:00,337050,CREDIT On Market 1208870000010189,,2.0,,5.0
2024-11-27 00:00:00,,Closing Balance,,,,5.0
ISIN: INE042A01014,ISIN Name: ESCORTS KUBOTA  EQ,,,,,
2024-03-01 00:00:00,,Opening Balance,,,,0.0
2024-07-24 00:00:00,948022,CREDIT On Market 1208870000010189,,1.0,,1.0
2024-08-20 00:00:00,280766,CREDIT On Market 1208870000010189,,1.0,,2.0
2024-11-27 00:00:00,,Closing Balance,,,,2.0
ISIN: INE935A01035,ISIN Name: GLENMARK PHA-EQ RE 1,,,,,
2024-03-01 00:00:00,,Opening Balance,,,,0.0
2024-07-19 00:00:00,565972,CREDIT On Market 1208870000010189,,1.0,,1.0
2024-08-20 00:00:00,280981,CREDIT On Market 1208870000010189,,2.0,,3.0
2024-11-27 00:00:00,,Closing Balance,,,,3.0
ISIN: INE541A01023,ISIN Name: GMM PFAUDLER-EQ RS2,,,,,
2024-03-01 00:00:00,,Opening Balance,,,,0.0
2024-08-20 00:00:00,280921,CREDIT On Market 1208870000010189,,4.0,,4.0
2024-08-29 00:00:00,744417,CREDIT On Market 1208870000010189,,1.0,,5.0
2024-11-27 00:00:00,,Closing Balance,,,,5.0
ISIN: INE776C01039,ISIN Name: GMR AIRPOR - EQ RE 1,,,,,
2024-03-01 00:00:00,,Opening Balance,,,,0.0
2024-06-14 00:00:00,261798,CREDIT On Market 1208870000010189,,25.0,,25.0
2024-07-18 00:00:00,94149519,DEBIT On Market 1100001100021102,1211232024134.0,,15.0,10.0
2024-07-19 00:00:00,94149519,CREDIT On Market 1100001100021102,1211232024134.0,15.0,,25.0
2024-07-19 00:00:00,94149519,DEBIT On Market 1100001100021102,1211232024134.0,,15.0,10.0
2024-07-22 00:00:00,98090042,DEBIT On Market 1100001100021102,1211232024135.0,,5.0,0.0
2024-07-22 00:00:00,98090042,CREDIT On Market 1100001100021102,1211232024135.0,5.0,,5.0
2024-07-25 00:00:00,922455,CREDIT On Market 1208870000010189,,5.0,,10.0
2024-08-20 00:00:00,280951,CREDIT On Market 1208870000010189,,15.0,,25.0
2024-11-27 00:00:00,,Closing Balance,,,,25.0
ISIN: INE484J01027,ISIN Name: GODREJ PROPER EQ 5/-,,,,,
2024-03-01 00:00:00,,Opening Balance,,,,0.0
2024-05-27 00:00:00,319334,CREDIT On Market 1208870000010189,,1.0,,1.0
2024-06-25 00:00:00,337007,CREDIT On Market 1208870000010189,,1.0,,2.0
2024-11-27 00:00:00,,Closing Balance,,,,2.0
ISIN: INE844O01030,ISIN Name: GUJARAT GAS-EQ2/-,,,,,
2024-03-01 00:00:00,,Opening Balance,,,,0.0
2024-09-03 00:00:00,486399,CREDIT On Market 1208870000010189,,5.0,,5.0
2024-11-27 00:00:00,,Closing Balance,,,,5.0
ISIN: INE176B01034,ISIN Name: HAVELLS INDIA-EQ,,,,,
2024-03-01 00:00:00,,Opening Balance,,,,0.0
2024-05-06 00:00:00,913586,CREDIT On Market 1208870000010189,,2.0,,2.0
2024-05-31 00:00:00,589904,CREDIT On Market 1208870000010189,,2.0,,4.0
2024-06-18 00:00:00,104826,CREDIT On Market 1208870000010189,,1.0,,5.0
2024-06-19 00:00:00,33082188,DEBIT On Market 1100001100021102,1211232024114.0,,2.0,3.0
2024-06-20 00:00:00,33082188,DEBIT On Market 1100001100021102,1211232024114.0,,2.0,1.0
2024-06-20 00:00:00,33082188,CREDIT On Market 1100001100021102,1211232024114.0,2.0,,3.0
2024-06-20 00:00:00,34574530,DEBIT On Market 1100001100021102,1211232024115.0,,1.0,2.0
2024-06-21 00:00:00,34574530,CREDIT On Market 1100001100021102,1211232024115.0,1.0,,3.0
2024-06-21 00:00:00,34574530,DEBIT On Market 1100001100021102,1211232024115.0,,1.0,2.0
2024-07-10 00:00:00,79208781,DEBIT On Market 1100001100021102,1211232024129.0,,1.0,1.0
2024-07-11 00:00:00,79208781,CREDIT On Market 1100001100021102,1211232024129.0,1.0,,2.0
2024-07-11 00:00:00,79208781,DEBIT On Market 1100001100021102,1211232024129.0,,1.0,1.0
2024-07-19 00:00:00,251505,CREDIT On Market 1208870000010189,,2.0,,3.0
2024-07-19 00:00:00,98241755,DEBIT On Market 1100001100021102,1211232024135.0,,1.0,2.0
2024-07-22 00:00:00,98241755,CREDIT On Market 1100001100021102,1211232024135.0,1.0,,3.0
2024-07-22 00:00:00,98241755,DEBIT On Market 1100001100021102,1211232024135.0,,1.0,2.0
2024-07-30 00:00:00,19059973,DEBIT On Market 1100001100021102,1211232024142.0,,1.0,1.0
2024-07-31 00:00:00,19059973,CREDIT On Market 1100001100021102,1211232024142.0,1.0,,2.0
2024-07-31 00:00:00,19059973,DEBIT On Market 1100001100021102,1211232024142.0,,1.0,1.0
2024-11-27 00:00:00,,Closing Balance,,,,1.0
ISIN: INE040A01034,ISIN Name: HDFC BANK-EQ1/-,,,,,
2024-03-01 00:00:00,,Opening Balance,,,,0.0
2024-03-27 00:00:00,690862,CREDIT On Market 1208870000010189,,1.0,,1.0
2024-04-05 00:00:00,135244,CREDIT On Market 1208870000010189,,1.0,,2.0
2024-06-03 00:00:00,121494,CREDIT On Market 1208870000010189,,2.0,,4.0
2024-06-05 00:00:00,770708,CREDIT On Market 1208870000010189,,1.0,,5.0
2024-06-14 00:00:00,945668,CREDIT On Market 1208870000010189,,3.0,,8.0
2024-07-19 00:00:00,985380,CREDIT On Market 1208870000010189,,2.0,,10.0
2024-07-23 00:00:00,978117,CREDIT On Market 1208870000010189,,2.0,,12.0
2024-07-25 00:00:00,9152410,DEBIT On Market 1100001100021102,1211232024139.0,,6.0,6.0
2024-07-26 00:00:00,9152410,DEBIT On Market 1100001100021102,1211232024139.0,,6.0,0.0
2024-07-26 00:00:00,9152410,CREDIT On Market 1100001100021102,1211232024139.0,6.0,,6.0
2024-11-27 00:00:00,,Closing Balance,,,,6.0
ISIN: INE158A01026,ISIN Name: HERO MOTOCO (RS.2/-),,,,,
2024-03-01 00:00:00,,Opening Balance,,,,0.0
2024-06-19 00:00:00,381163,CREDIT On Market 1208870000010189,,2.0,,2.0
2024-06-20 00:00:00,34630832,DEBIT On Market 1100001100021102,1211232024115.0,,1.0,1.0
2024-06-21 00:00:00,34630832,DEBIT On Market 1100001100021102,1211232024115.0,,1.0,0.0
2024-06-21 00:00:00,34630832,CREDIT On Market 1100001100021102,1211232024115.0,1.0,,1.0
2024-06-27 00:00:00,50012559,DEBIT On Market 1100001100021102,1211232024120.0,,1.0,1.0
2024-06-27 00:00:00,50012559,CREDIT On Market 1100001100021102,1211232024120.0,1.0,,2.0
2024-07-18 00:00:00,94156097,DEBIT On Market 1100001100021102,1211232024134.0,,1.0,1.0
2024-07-19 00:00:00,94156097,DEBIT On Market 1100001100021102,1211232024134.0,,1.0,0.0
2024-07-19 00:00:00,94156097,CREDIT On Market 1100001100021102,1211232024134.0,1.0,,1.0
2024-08-01 00:00:00,676474,CREDIT On Market 1208870000010189,,1.0,,2.0
2024-08-02 00:00:00,472947,CREDIT On Market 1208870000010189,,1.0,,3.0
2024-11-27 00:00:00,,Closing Balance,,,,3.0
ISIN: INE066F01020,ISIN Name: HINDUSTAN AERO-EQ5/-,,,,,
2024-03-01 00:00:00,,Opening Balance,,,,0.0
2024-06-06 00:00:00,433698,CREDIT On Market 1208870000010189,,1.0,,1.0
2024-06-07 00:00:00,418879,CREDIT On Market 1208870000010189,,2.0,,3.0
2024-06-18 00:00:00,489288,CREDIT On Market 1208870000010189,,2.0,,5.0
2024-07-18 00:00:00,95227294,DEBIT On Market 1100001100021102,1211232024134.0,,3.0,2.0
2024-07-19 00:00:00,95227294,CREDIT On Market 1100001100021102,1211232024134.0,3.0,,5.0
2024-07-19 00:00:00,95227294,DEBIT On Market 1100001100021102,1211232024134.0,,3.0,2.0
2024-07-19 00:00:00,98149781,DEBIT On Market 1100001100021102,1211232024135.0,,1.0,1.0
2024-07-22 00:00:00,98149781,DEBIT On Market 1100001100021102,1211232024135.0,,1.0,0.0
2024-07-22 00:00:00,98149781,CREDIT On Market 1100001100021102,1211232024135.0,1.0,,1.0
2024-07-23 00:00:00,978155,CREDIT On Market 1208870000010189,,1.0,,2.0
2024-07-29 00:00:00,262184,CREDIT On Market 1208870000010189,,1.0,,3.0
2024-08-02 00:00:00,27792576,DEBIT On Market 1100001100021102,1211232024145.0,,1.0,2.0
2024-08-05 00:00:00,27792576,DEBIT On Market 1100001100021102,1211232024145.0,,1.0,1.0
2024-08-05 00:00:00,27792576,CREDIT On Market 1100001100021102,1211232024145.0,1.0,,2.0
2024-09-05 00:00:00,216152,CREDIT On Market 1208870000010189,,1.0,,3.0
2024-11-27 00:00:00,,Closing Balance,,,,3.0
ISIN: INE030A01027,ISIN Name: HINDUSTAN UNILEV RE1,,,,,
2024-03-01 00:00:00,,Opening Balance,,,,0.0
2024-04-23 00:00:00,248432,CREDIT On Market 1208870000010189,,1.0,,1.0
2024-06-06 00:00:00,433615,CREDIT On Market 1208870000010189,,1.0,,2.0
2024-07-23 00:00:00,978082,CREDIT On Market 1208870000010189,,1.0,,3.0
2024-07-25 00:00:00,9141096,DEBIT On Market 1100001100021102,1211232024139.0,,1.0,2.0
2024-07-26 00:00:00,9141096,CREDIT On Market 1100001100021102,1211232024139.0,1.0,,3.0
2024-07-26 00:00:00,9141096,DEBIT On Market 1100001100021102,1211232024139.0,,1.0,2.0
2024-07-29 00:00:00,184655,CREDIT On Market 1208870000010189,,1.0,,3.0
2024-07-31 00:00:00,22983475,DEBIT On Market 1100001100021102,1211232024143.0,,1.0,2.0
2024-08-01 00:00:00,22983475,CREDIT On Market 1100001100021102,1211232024143.0,1.0,,3.0
2024-08-01 00:00:00,22983475,DEBIT On Market 1100001100021102,1211232024143.0,,1.0,2.0
2024-11-27 00:00:00,,Closing Balance,,,,2.0
ISIN: INE094A01015,ISIN Name: HPCL EQUITY,,,,,
2024-03-01 00:00:00,,Opening Balance,,,,0.0
2024-04-22 00:00:00,770955,CREDIT On Market 1208870000010189,,2.0,,2.0
2024-06-03 00:00:00,508466,CREDIT On Market 1208870000010189,,3.0,,5.0
2024-06-26 00:00:00,46714619,CREDIT On Market 1100001100021102,1211232024119.0,2.0,,7.0
2024-06-26 00:00:00,46714619,DEBIT On Market 1100001100021102,1211232024119.0,,5.0,2.0
2024-06-27 00:00:00,46714619,DEBIT On Market 1100001100021102,1211232024119.0,,3.0,-1.0
2024-06-27 00:00:00,46714619,CREDIT On Market 1100001100021102,1211232024119.0,3.0,,2.0
2024-06-28 00:00:00,302239,CREDIT On Market 1208870000010189,,1.0,,3.0
2024-07-05 00:00:00,411225,CREDIT Corporate Action TRANSFER_ON_LISTING_APPROVAL,,2.0,,5.0
2024-07-10 00:00:00,446456,CREDIT On Market 1208870000010189,,5.0,,10.0
2024-07-18 00:00:00,94183636,DEBIT On Market 1100001100021102,1211232024134.0,,5.0,5.0
2024-07-19 00:00:00,94183636,DEBIT On Market 1100001100021102,1211232024134.0,,5.0,0.0
2024-07-19 00:00:00,94183636,CREDIT On Market 1100001100021102,1211232024134.0,5.0,,5.0
2024-08-01 00:00:00,444559,CREDIT On Market 1208870000010189,,5.0,,10.0
2024-11-27 00:00:00,,Closing Balance,,,,10.0
2024-03-01 00:00:00,,Opening Balance,,,,0.0
2024-07-01 00:00:00,240822,CREDIT Corporate Action BONUS,,2.0,,2.0
2024-07-05 00:00:00,411225,DEBIT Corporate Action TRANSFER_ON_LISTING_APPROVAL,,,2.0,0.0
2024-11-27 00:00:00,,Closing Balance,,,,0.0
ISIN: INE090A01021,ISIN Name: ICICI BANK-EQ,,,,,
2024-03-01 00:00:00,,Opening Balance,,,,0.0
2024-08-01 00:00:00,977409,CREDIT On Market 1208870000010189,,2.0,,2.0
2024-11-27 00:00:00,,Closing Balance,,,,2.0
ISIN: INE092T01019,ISIN Name: IDFC FIRST BANK-EQ,,,,,
2024-03-01 00:00:00,,Opening Balance,,,,0.0
2024-08-27 00:00:00,150654,CREDIT On Market 1208870000010189,,25.0,,25.0
2024-09-13 00:00:00,304401,CREDIT On Market 1208870000010189,,5.0,,30.0
2024-11-27 00:00:00,,Closing Balance,,,,30.0
ISIN: INE242A01010,ISIN Name: INDIAN OIL CORP EQ,,,,,
2024-03-01 00:00:00,,Opening Balance,,,,0.0
2024-04-15 00:00:00,478661,CREDIT On Market 1208870000010189,,10.0,,10.0
2024-05-16 00:00:00,909388,CREDIT On Market 1208870000010189,,10.0,,20.0
2024-11-27 00:00:00,,Closing Balance,,,,20.0
ISIN: INE202E01016,ISIN Name: INDIAN RENEWABLE-EQ,,,,,
2024-03-01 00:00:00,,Opening Balance,,,,0.0
2024-06-06 00:00:00,433853,CREDIT On Market 1208870000010189,,5.0,,5.0
2024-06-24 00:00:00,524522,CREDIT On Market 1208870000010189,,5.0,,10.0
2024-07-05 00:00:00,985251,CREDIT On Market 1208870000010189,,5.0,,15.0
2024-07-10 00:00:00,446486,CREDIT On Market 1208870000010189,,10.0,,25.0
2024-07-15 00:00:00,89047344,DEBIT On Market 1100001100021102,1211232024132.0,,5.0,20.0
2024-07-15 00:00:00,89029369,DEBIT On Market 1100001100021102,1211232024132.0,,10.0,10.0
2024-07-16 00:00:00,89029369,DEBIT On Market 1100001100021102,1211232024132.0,,10.0,0.0
2024-07-16 00:00:00,89029369,CREDIT On Market 1100001100021102,1211232024132.0,10.0,,10.0
2024-07-16 00:00:00,89047344,DEBIT On Market 1100001100021102,1211232024132.0,,5.0,5.0
2024-07-16 00:00:00,89047344,CREDIT On Market 1100001100021102,1211232024132.0,5.0,,10.0
2024-07-18 00:00:00,836188,CREDIT On Market 1208870000010189,,10.0,,20.0
2024-07-18 00:00:00,94149657,DEBIT On Market 1100001100021102,1211232024134.0,,10.0,10.0
2024-07-19 00:00:00,94149657,CREDIT On Market 1100001100021102,1211232024134.0,10.0,,20.0
2024-07-19 00:00:00,94149657,DEBIT On Market 1100001100021102,1211232024134.0,,10.0,10.0
2024-07-22 00:00:00,436270,CREDIT On Market 1208870000010189,,5.0,,15.0
2024-07-25 00:00:00,922329,CREDIT On Market 1208870000010189,,5.0,,20.0
2024-07-30 00:00:00,503867,CREDIT On Market 1208870000010189,,10.0,,30.0
2024-08-01 00:00:00,26605335,DEBIT On Market 1100001100021102,1211232024144.0,,10.0,20.0
2024-08-02 00:00:00,26605335,CREDIT On Market 1100001100021102,1211232024144.0,10.0,,30.0
2024-08-02 00:00:00,26605335,DEBIT On Market 1100001100021102,1211232024144.0,,10.0,20.0
2024-11-27 00:00:00,,Closing Balance,,,,20.0
ISIN: INE121J01017,ISIN Name: INDUS TOWERS LTD-EQ,,,,,
2024-03-01 00:00:00,,Opening Balance,,,,0.0
2024-06-11 00:00:00,993969,CREDIT On Market 1208870000010189,,5.0,,5.0
2024-06-18 00:00:00,27595681,DEBIT On Market 1100001100021102,1211232024113.0,,5.0,0.0
2024-06-19 00:00:00,27595681,DEBIT On Market 1100001100021102,1211232024113.0,,5.0,-5.0
2024-06-19 00:00:00,27595681,CREDIT On Market 1100001100021102,1211232024113.0,5.0,,0.0
2024-11-27 00:00:00,,Closing Balance,,,,0.0
ISIN: INE009A01021,ISIN Name: INFOSYS LTD-EQ 5/-,,,,,
2024-03-01 00:00:00,,Opening Balance,,,,0.0
2024-04-25 00:00:00,702017,CREDIT On Market 1208870000010189,,2.0,,2.0
2024-06-14 00:00:00,918663,CREDIT On Market 1208870000010189,,2.0,,4.0
2024-06-19 00:00:00,381037,CREDIT On Market 1208870000010189,,1.0,,5.0
2024-07-22 00:00:00,436175,CREDIT On Market 1208870000010189,,5.0,,10.0
2024-08-05 00:00:00,30216308,DEBIT On Market 1100001100021102,1211232024146.0,,5.0,5.0
2024-08-06 00:00:00,30216308,DEBIT On Market 1100001100021102,1211232024146.0,,5.0,5.0
2024-11-27 00:00:00,,Closing Balance,,,,5.0
ISIN: INE066P01011,ISIN Name: INOX WIND- EQ,,,,,
2024-03-01 00:00:00,,Opening Balance,,,,0.0
2024-07-09 00:00:00,157623,CREDIT On Market 1208870000010189,,25.0,,25.0
2024-07-10 00:00:00,79213191,DEBIT On Market 1100001100021102,1211232024129.0,,15.0,10.0
2024-07-11 00:00:00,79213191,CREDIT On Market 1100001100021102,1211232024129.0,15.0,,25.0
2024-07-11 00:00:00,79213191,DEBIT On Market 1100001100021102,1211232024129.0,,15.0,10.0
2024-07-16 00:00:00,235678,CREDIT On Market 1208870000010189,,10.0,,20.0
2024-07-19 00:00:00,784798,CREDIT On Market 1208870000010189,,5.0,,25.0
2024-07-19 00:00:00,98130305,DEBIT On Market 1100001100021102,1211232024135.0,,15.0,10.0
2024-07-22 00:00:00,98130305,DEBIT On Market 1100001100021102,1211232024135.0,,15.0,-5.0
2024-07-22 00:00:00,98130305,CREDIT On Market 1100001100021102,1211232024135.0,15.0,,10.0
2024-07-22 00:00:00,1159003,DEBIT On Market 1100001100021102,1211232024136.0,,5.0,5.0
2024-07-23 00:00:00,1159003,CREDIT On Market 1100001100021102,1211232024136.0,5.0,,10.0
2024-07-23 00:00:00,1159003,DEBIT On Market 1100001100021102,1211232024136.0,,5.0,5.0
2024-07-30 00:00:00,503578,CREDIT On Market 1208870000010189,,5.0,,10.0
2024-08-14 00:00:00,336666,CREDIT On Market 1208870000010189,,5.0,,15.0
2024-08-16 00:00:00,657700,CREDIT On Market 1208870000010189,,5.0,,20.0
2024-11-27 00:00:00,,Closing Balance,,,,20.0
ISIN: INE646L01027,ISIN Name: INTERGLOBE AVIA-EQ,,,,,
2024-03-01 00:00:00,,Opening Balance,,,,0.0
2024-04-15 00:00:00,478693,CREDIT On Market 1208870000010189,,2.0,,2.0
2024-05-27 00:00:00,796847,CREDIT On Market 1208870000010189,,2.0,,4.0
2024-06-11 00:00:00,951782,CREDIT On Market 1208870000010189,,1.0,,5.0
2024-06-20 00:00:00,34722114,DEBIT On Market 1100001100021102,1211232024115.0,,2.0,3.0
2024-06-21 00:00:00,34722114,DEBIT On Market 1100001100021102,1211232024115.0,,2.0,1.0
2024-06-21 00:00:00,34722114,CREDIT On Market 1100001100021102,1211232024115.0,2.0,,3.0
2024-06-24 00:00:00,466251,CREDIT On Market 1208870000010189,,1.0,,4.0
2024-07-18 00:00:00,94149432,DEBIT On Market 1100001100021102,1211232024134.0,,2.0,2.0
2024-07-19 00:00:00,94149432,CREDIT On Market 1100001100021102,1211232024134.0,2.0,,4.0
2024-07-19 00:00:00,94149432,DEBIT On Market 1100001100021102,1211232024134.0,,2.0,2.0
2024-07-19 00:00:00,98183353,DEBIT On Market 1100001100021102,1211232024135.0,,1.0,1.0
2024-07-22 00:00:00,98183353,CREDIT On Market 1100001100021102,1211232024135.0,1.0,,2.0
2024-07-22 00:00:00,98183353,DEBIT On Market 1100001100021102,1211232024135.0,,1.0,1.0
2024-11-27 00:00:00,,Closing Balance,,,,1.0
ISIN: INE335Y01020,ISIN Name: IRCTCL-EQ2/-,,,,,
2024-03-01 00:00:00,,Opening Balance,,,,0.0
2024-06-07 00:00:00,419406,CREDIT On Market 1208870000010189,,5.0,,5.0
2024-06-12 00:00:00,897776,CREDIT On Market 1208870000010189,,2.0,,7.0
2024-07-18 00:00:00,95486032,DEBIT On Market 1100001100021102,1211232024134.0,,2.0,5.0
2024-07-19 00:00:00,95486032,CREDIT On Market 1100001100021102,1211232024134.0,2.0,,7.0
2024-07-19 00:00:00,95486032,DEBIT On Market 1100001100021102,1211232024134.0,,2.0,5.0
2024-07-23 00:00:00,978330,CREDIT On Market 1208870000010189,,2.0,,7.0
2024-11-27 00:00:00,,Closing Balance,,,,7.0
ISIN: INE154A01025,ISIN Name: ITC LIMITED -EQ RE.1,,,,,
2024-03-01 00:00:00,,Opening Balance,,,,0.0
2024-06-19 00:00:00,381098,CREDIT On Market 1208870000010189,,5.0,,5.0
2024-07-23 00:00:00,978220,CREDIT On Market 1208870000010189,,5.0,,10.0
2024-07-24 00:00:00,948075,CREDIT On Market 1208870000010189,,5.0,,15.0
2024-08-02 00:00:00,27758483,DEBIT On Market 1100001100021102,1211232024145.0,,5.0,10.0
2024-08-05 00:00:00,27758483,DEBIT On Market 1100001100021102,1211232024145.0,,5.0,5.0
2024-08-05 00:00:00,27758483,CREDIT On Market 1100001100021102,1211232024145.0,5.0,,10.0
2024-11-27 00:00:00,,Closing Balance,,,,10.0
ISIN: INE758E01017,ISIN Name: JIO FINANCIAL -EQ,,,,,
2024-03-27 00:00:00,240497,CREDIT On Market 1208870000010189,,5.0,,5.0
2024-07-18 00:00:00,836573,CREDIT On Market 1208870000010189,,5.0,,10.0
2024-07-18 00:00:00,94145660,DEBIT On Market 1100001100021102,1211232024134.0,,5.0,5.0
2024-07-19 00:00:00,94145660,DEBIT On Market 1100001100021102,1211232024134.0,,5.0,0.0
2024-07-19 00:00:00,94145660,CREDIT On Market 1100001100021102,1211232024134.0,5.0,,5.0
2024-11-27 00:00:00,,Closing Balance,,,,5.0
ISIN: INE121E01018,ISIN Name: JSW ENERGY LTD - EQ,,,,,
2024-03-01 00:00:00,,Opening Balance,,,,0.0
2024-04-05 00:00:00,467934,CREDIT On Market 1208870000010189,,4.0,,4.0
2024-06-14 00:00:00,398751,CREDIT On Market 1208870000010189,,4.0,,8.0
2024-06-18 00:00:00,116817,CREDIT On Market 1208870000010189,,2.0,,10.0
2024-06-25 00:00:00,336936,CREDIT On Market 1208870000010189,,5.0,,15.0
2024-07-02 00:00:00,206695,CREDIT On Market 1208870000010189,,5.0,,20.0
2024-07-10 00:00:00,79234714,DEBIT On Market 1100001100021102,1211232024129.0,,5.0,15.0
2024-07-11 00:00:00,79234714,DEBIT On Market 1100001100021102,1211232024129.0,,5.0,10.0
2024-07-11 00:00:00,79234714,CREDIT On Market 1100001100021102,1211232024129.0,5.0,,15.0
2024-07-18 00:00:00,94160000,DEBIT On Market 1100001100021102,1211232024134.0,,5.0,10.0
2024-07-19 00:00:00,94160000,CREDIT On Market 1100001100021102,1211232024134.0,5.0,,15.0
2024-07-19 00:00:00,94160000,DEBIT On Market 1100001100021102,1211232024134.0,,5.0,10.0
2024-07-23 00:00:00,4555747,DEBIT On Market 1100001100021102,1211232024137.0,,4.0,6.0
2024-07-23 00:00:00,4873975,DEBIT On Market 1100001100021102,1211232024137.0,,1.0,5.0
2024-07-24 00:00:00,4555747,DEBIT On Market 1100001100021102,1211232024137.0,,4.0,1.0
2024-07-24 00:00:00,4555747,CREDIT On Market 1100001100021102,1211232024137.0,4.0,,5.0
2024-07-24 00:00:00,4873975,DEBIT On Market 1100001100021102,1211232024137.0,,1.0,4.0
2024-07-24 00:00:00,4873975,CREDIT On Market 1100001100021102,1211232024137.0,1.0,,5.0
2024-11-27 00:00:00,,Closing Balance,,,,5.0
ISIN: INE880J01026,ISIN Name: JSW INFRASTRU-EQ,,,,,
2024-03-01 00:00:00,,Opening Balance,,,,0.0
2024-07-19 00:00:00,99595431,DEBIT On Market 1100001100021102,1211232024135.0,,3.0,-3.0
2024-07-19 00:00:00,296512,CREDIT On Market 1208870000010189,,5.0,,2.0
2024-07-22 00:00:00,99595431,CREDIT On Market 1100001100021102,1211232024135.0,3.0,,5.0
2024-07-22 00:00:00,99595431,DEBIT On Market 1100001100021102,1211232024135.0,,3.0,2.0
2024-07-23 00:00:00,978440,CREDIT On Market 1208870000010189,,3.0,,5.0
2024-08-02 00:00:00,27766008,DEBIT On Market 1100001100021102,1211232024145.0,,3.0,2.0
2024-08-05 00:00:00,27766008,DEBIT On Market 1100001100021102,1211232024145.0,,3.0,-1.0
2024-08-05 00:00:00,27766008,CREDIT On Market 1100001100021102,1211232024145.0,3.0,,2.0
2024-11-27 00:00:00,,Closing Balance,,,,2.0
ISIN: INE455I01029,ISIN Name: KAVERI SEED CO EQ2/-,,,,,
2024-03-01 00:00:00,,Opening Balance,,,,0.0
2024-07-24 00:00:00,948127,CREDIT On Market 1208870000010189,,5.0,,5.0
2024-11-27 00:00:00,,Closing Balance,,,,5.0
ISIN: INE237A01028,ISIN Name: KOTAK MAHINDRA-EQ5/-,,,,,
2024-03-01 00:00:00,,Opening Balance,,,,0.0
2024-06-03 00:00:00,258196,CREDIT On Market 1208870000010189,,1.0,,1.0
2024-06-26 00:00:00,970205,CREDIT On Market 1208870000010189,,2.0,,3.0
2024-07-25 00:00:00,9148842,DEBIT On Market 1100001100021102,1211232024139.0,,1.0,2.0
2024-07-26 00:00:00,9148842,CREDIT On Market 1100001100021102,1211232024139.0,1.0,,3.0
2024-07-26 00:00:00,9148842,DEBIT On Market 1100001100021102,1211232024139.0,,1.0,2.0
2024-11-27 00:00:00,,Closing Balance,,,,2.0
ISIN: INE018A01030,ISIN Name: LARSEN & TOUBR-EQ2/-,,,,,
2024-03-01 00:00:00,,Opening Balance,,,,0.0
2024-03-27 00:00:00,654406,CREDIT On Market 1208870000010189,,1.0,,1.0
2024-04-29 00:00:00,262894,CREDIT On Market 1208870000010189,,1.0,,2.0
2024-05-15 00:00:00,371834,CREDIT On Market 1208870000010189,,1.0,,3.0
2024-05-16 00:00:00,635253,CREDIT On Market 1208870000010189,,1.0,,4.0
2024-06-24 00:00:00,38321944,CREDIT On Market 1100001100021102,1211232024116.0,1.0,,4.0
2024-06-24 00:00:00,38321944,DEBIT On Market 1100001100021102,1211232024116.0,,1.0,3.0
2024-07-19 00:00:00,98157357,DEBIT On Market 1100001100021102,1211232024135.0,,1.0,2.0
2024-07-22 00:00:00,98157357,CREDIT On Market 1100001100021102,1211232024135.0,1.0,,3.0
2024-07-22 00:00:00,98157357,DEBIT On Market 1100001100021102,1211232024135.0,,1.0,2.0
2024-07-24 00:00:00,947967,CREDIT On Market 1208870000010189,,1.0,,3.0
2024-07-25 00:00:00,9162845,DEBIT On Market 1100001100021102,1211232024139.0,,2.0,1.0
2024-07-26 00:00:00,9162845,DEBIT On Market 1100001100021102,1211232024139.0,,2.0,-1.0
2024-07-26 00:00:00,9162845,CREDIT On Market 1100001100021102,1211232024139.0,2.0,,1.0
2024-07-30 00:00:00,503396,CREDIT On Market 1208870000010189,,2.0,,3.0
2024-11-27 00:00:00,,Closing Balance,,,,3.0
ISIN: INE970X01018,ISIN Name: LEMON TREE HOTELS-EQ,,,,,
2024-03-01 00:00:00,,Opening Balance,,,,0.0
2024-06-07 00:00:00,419933,CREDIT On Market 1208870000010189,,10.0,,10.0
2024-07-09 00:00:00,75386865,DEBIT On Market 1100001100021102,1211232024128.0,,5.0,5.0
2024-07-09 00:00:00,75407525,CREDIT On Market 1100001100021102,1211232024128.0,5.0,,10.0
2024-07-09 00:00:00,75407525,DEBIT On Market 1100001100021102,1211232024128.0,,5.0,5.0
2024-07-10 00:00:00,75386865,DEBIT On Market 1100001100021102,1211232024128.0,,5.0,0.0
2024-07-10 00:00:00,75386865,CREDIT On Market 1100001100021102,1211232024128.0,5.0,,5.0
2024-07-18 00:00:00,95411898,DEBIT On Market 1100001100021102,1211232024134.0,,3.0,2.0
2024-07-19 00:00:00,95411898,DEBIT On Market 1100001100021102,1211232024134.0,,3.0,-1.0
2024-07-19 00:00:00,95411898,CREDIT On Market 1100001100021102,1211232024134.0,3.0,,2.0
2024-08-14 00:00:00,738614,CREDIT On Market 1208870000010189,,8.0,,10.0
2024-08-30 00:00:00,971940,CREDIT On Market 1208870000010189,,10.0,,20.0
2024-11-27 00:00:00,,Closing Balance,,,,20.0
ISIN: INE101A01026,ISIN Name: MAH & MAH EQ RS 5/-,,,,,
2024-03-01 00:00:00,,Opening Balance,,,,0.0
2024-04-23 00:00:00,248485,CREDIT On Market 1208870000010189,,1.0,,1.0
2024-05-27 00:00:00,435510,CREDIT On Market 1208870000010189,,1.0,,2.0
2024-06-03 00:00:00,960344,CREDIT On Market 1208870000010189,,2.0,,4.0
2024-06-07 00:00:00,419103,CREDIT On Market 1208870000010189,,1.0,,5.0
2024-06-14 00:00:00,390402,CREDIT On Market 1208870000010189,,1.0,,6.0
2024-06-20 00:00:00,199506,CREDIT On Market 1208870000010189,,1.0,,7.0
2024-06-24 00:00:00,571750,CREDIT On Market 1208870000010189,,1.0,,8.0
2024-07-10 00:00:00,79168164,DEBIT On Market 1100001100021102,1211232024129.0,,3.0,5.0
2024-07-11 00:00:00,79168164,CREDIT On Market 1100001100021102,1211232024129.0,3.0,,8.0
2024-07-11 00:00:00,79168164,DEBIT On Market 1100001100021102,1211232024129.0,,3.0,5.0
2024-07-18 00:00:00,94152946,DEBIT On Market 1100001100021102,1211232024134.0,,2.0,3.0
2024-07-19 00:00:00,94152946,CREDIT On Market 1100001100021102,1211232024134.0,2.0,,5.0
2024-07-19 00:00:00,94152946,DEBIT On Market 1100001100021102,1211232024134.0,,2.0,3.0
2024-07-22 00:00:00,436227,CREDIT On Market 1208870000010189,,1.0,,4.0
2024-07-23 00:00:00,978189,CREDIT On Market 1208870000010189,,1.0,,5.0
2024-07-25 00:00:00,9166373,DEBIT On Market 1100001100021102,1211232024139.0,,2.0,3.0
2024-07-26 00:00:00,9166373,CREDIT On Market 1100001100021102,1211232024139.0,2.0,,5.0
2024-07-26 00:00:00,9166373,DEBIT On Market 1100001100021102,1211232024139.0,,2.0,3.0
2024-11-27 00:00:00,,Closing Balance,,,,3.0
ISIN: INE585B01010,ISIN Name: MARUTI SUZUKI IND-EQ,,,,,
2024-03-01 00:00:00,,Opening Balance,,,,0.0
2024-04-15 00:00:00,478677,CREDIT On Market 1208870000010189,,1.0,,1.0
2024-04-26 00:00:00,452170,CREDIT On Market 1208870000010189,,1.0,,2.0
2024-04-29 00:00:00,262991,CREDIT On Market 1208870000010189,,2.0,,4.0
2024-06-04 00:00:00,99521512,DEBIT On Market 1100001100021102,1211232024104.0,,2.0,2.0
2024-06-04 00:00:00,99521512,CREDIT On Market 1100001100021102,1211232024104.0,1.0,,3.0
2024-06-05 00:00:00,99521512,CREDIT On Market 1100001100021102,1211232024104.0,1.0,,4.0
2024-06-05 00:00:00,99521512,DEBIT On Market 1100001100021102,1211232024104.0,,1.0,3.0
2024-06-14 00:00:00,25229071,DEBIT On Market 1100001100021102,1211232024112.0,,1.0,3.0
2024-06-18 00:00:00,25229071,CREDIT On Market 1100001100021102,1211232024112.0,1.0,,4.0
2024-06-18 00:00:00,25229071,DEBIT On Market 1100001100021102,1211232024112.0,,1.0,3.0
2024-06-27 00:00:00,49993729,DEBIT On Market 1100001100021102,1211232024120.0,,3.0,0.0
2024-06-27 00:00:00,49993729,CREDIT On Market 1100001100021102,1211232024120.0,2.0,,2.0
2024-06-28 00:00:00,49993729,CREDIT On Market 1100001100021102,1211232024120.0,1.0,,3.0
2024-06-28 00:00:00,49993729,DEBIT On Market 1100001100021102,1211232024120.0,,1.0,2.0
2024-07-02 00:00:00,206789,CREDIT On Market 1208870000010189,,1.0,,3.0
2024-07-18 00:00:00,94147906,DEBIT On Market 1100001100021102,1211232024134.0,,1.0,2.0
2024-07-19 00:00:00,94147906,DEBIT On Market 1100001100021102,1211232024134.0,,1.0,1.0
2024-07-19 00:00:00,94147906,CREDIT On Market 1100001100021102,1211232024134.0,1.0,,2.0
2024-07-23 00:00:00,4708834,DEBIT On Market 1100001100021102,1211232024137.0,,1.0,1.0
2024-07-24 00:00:00,4708834,CREDIT On Market 1100001100021102,1211232024137.0,1.0,,2.0
2024-07-24 00:00:00,4708834,DEBIT On Market 1100001100021102,1211232024137.0,,1.0,1.0
2024-07-25 00:00:00,922402,CREDIT On Market 1208870000010189,,1.0,,2.0
2024-08-01 00:00:00,447347,CREDIT On Market 1208870000010189,,1.0,,3.0
2024-11-27 00:00:00,,Closing Balance,,,,3.0
ISIN: INE139A01034,ISIN Name: NALCO EQ-RS 5/-,,,,,
2024-03-01 00:00:00,,Opening Balance,,,,0.0
2024-06-12 00:00:00,792914,CREDIT On Market 1208870000010189,,3.0,,3.0
2024-07-10 00:00:00,79179322,DEBIT On Market 1100001100021102,1211232024129.0,,2.0,1.0
2024-07-11 00:00:00,79179322,CREDIT On Market 1100001100021102,1211232024129.0,2.0,,3.0
2024-07-11 00:00:00,79179322,DEBIT On Market 1100001100021102,1211232024129.0,,2.0,1.0
2024-09-13 00:00:00,637743,CREDIT On Market 1208870000010189,,5.0,,6.0
2024-11-27 00:00:00,,Closing Balance,,,,6.0
ISIN: INE239A01024,ISIN Name: NESTLE INDIA-EQ1/-,,,,,
2024-03-01 00:00:00,,Opening Balance,,,,0.0
2024-04-05 00:00:00,464591,CREDIT On Market 1208870000010189,,2.0,,2.0
2024-06-04 00:00:00,193014,CREDIT On Market 1208870000010189,,1.0,,3.0
2024-06-20 00:00:00,34702692,DEBIT On Market 1100001100021102,1211232024115.0,,1.0,2.0
2024-06-21 00:00:00,34702692,CREDIT On Market 1100001100021102,1211232024115.0,1.0,,3.0
2024-06-21 00:00:00,34702692,DEBIT On Market 1100001100021102,1211232024115.0,,1.0,2.0
2024-07-29 00:00:00,231086,CREDIT On Market 1208870000010189,,1.0,,3.0
2024-11-27 00:00:00,,Closing Balance,,,,3.0
ISIN: INE848E01016,ISIN Name: NHPC LIMITED - EQ,,,,,
2024-03-01 00:00:00,,Opening Balance,,,,0.0
2024-09-03 00:00:00,486435,CREDIT On Market 1208870000010189,,30.0,,30.0
2024-11-27 00:00:00,,Closing Balance,,,,30.0
ISIN: INE733E01010,ISIN Name: NTPC LTD,,,,,
2024-03-01 00:00:00,,Opening Balance,,,,0.0
2024-06-10 00:00:00,707719,CREDIT On Market 1208870000010189,,5.0,,5.0
2024-07-23 00:00:00,978402,CREDIT On Market 1208870000010189,,5.0,,10.0
2024-07-24 00:00:00,948231,CREDIT On Market 1208870000010189,,5.0,,15.0
2024-11-27 00:00:00,,Closing Balance,,,,15.0
ISIN: INE982J01020,ISIN Name: ONE97 COMMUNIC-EQ1/-,,,,,
2024-03-01 00:00:00,,Opening Balance,,,,0.0
2024-06-14 00:00:00,338655,CREDIT On Market 1208870000010189,,10.0,,10.0
2024-06-18 00:00:00,27603023,DEBIT On Market 1100001100021102,1211232024113.0,,5.0,5.0
2024-06-19 00:00:00,27603023,CREDIT On Market 1100001100021102,1211232024113.0,5.0,,10.0
2024-06-19 00:00:00,27603023,DEBIT On Market 1100001100021102,1211232024113.0,,5.0,5.0
2024-06-21 00:00:00,38415167,DEBIT On Market 1100001100021102,1211232024116.0,,5.0,0.0
2024-06-24 00:00:00,38415167,DEBIT On Market 1100001100021102,1211232024116.0,,5.0,-5.0
2024-06-24 00:00:00,38415167,CREDIT On Market 1100001100021102,1211232024116.0,5.0,,0.0
2024-08-23 00:00:00,659729,CREDIT On Market 1208870000010189,,7.0,,7.0
2024-08-26 00:00:00,716994,CREDIT On Market 1208870000010189,,1.0,,8.0
ISIN: INE213A01029,ISIN Name: ONGC-EQ-RS.5/-,,,,,
2024-03-01 00:00:00,,Opening Balance,,,,0.0
2024-04-19 00:00:00,288128,CREDIT On Market 1208870000010189,,5.0,,5.0
2024-05-22 00:00:00,749511,CREDIT On Market 1208870000010189,,5.0,,10.0
2024-06-05 00:00:00,1268623,DEBIT On Market 1100001100021102,1211232024104.0,,5.0,5.0
2024-06-05 00:00:00,1268623,CREDIT On Market 1100001100021102,1211232024104.0,5.0,,10.0
2024-06-06 00:00:00,433939,CREDIT On Market 1208870000010189,,5.0,,15.0
2024-07-18 00:00:00,94171703,DEBIT On Market 1100001100021102,1211232024134.0,,5.0,10.0
2024-07-18 00:00:00,836317,CREDIT On Market 1208870000010189,,5.0,,15.0
2024-07-19 00:00:00,94171703,CREDIT On Market 1100001100021102,1211232024134.0,5.0,,20.0
2024-07-19 00:00:00,94171703,DEBIT On Market 1100001100021102,1211232024134.0,,5.0,15.0
2024-07-22 00:00:00,1330019,DEBIT On Market 1100001100021102,1211232024136.0,,5.0,10.0
2024-07-23 00:00:00,1330019,DEBIT On Market 1100001100021102,1211232024136.0,,5.0,5.0
2024-07-23 00:00:00,1330019,CREDIT On Market 1100001100021102,1211232024136.0,5.0,,10.0
2024-08-14 00:00:00,111139,CREDIT On Market 1208870000010189,,5.0,,15.0
2024-11-27 00:00:00,,Closing Balance,,,,10.0
ISIN: INE795A01017,ISIN Name: PANASONIC ENERGY-EQ,,,,,
2024-03-01 00:00:00,,Opening Balance,,,,0.0
2024-04-15 00:00:00,478710,CREDIT On Market 1208870000010189,,2.0,,2.0
2024-07-16 00:00:00,235763,CREDIT On Market 1208870000010189,,1.0,,3.0
2024-07-22 00:00:00,436321,CREDIT On Market 1208870000010189,,2.0,,5.0
2024-11-27 00:00:00,,Closing Balance,,,,5.0
ISIN: INE045601015,ISIN Name: PARAS DEFENCE-EQ,,,,,
2024-03-01 00:00:00,,Opening Balance,,,,0.0
2024-08-23 00:00:00,659682,CREDIT On Market 1208870000010189,,2.0,,2.0
2024-11-27 00:00:00,,Closing Balance,,,,2.0
ISIN: INE752E01010,ISIN Name: POWER GRID CORP - EQ,,,,,
2024-03-01 00:00:00,,Opening Balance,,,,0.0
2024-06-07 00:00:00,419650,CREDIT On Market 1208870000010189,,10.0,,10.0
2024-11-27 00:00:00,,Closing Balance,,,,10.0
ISIN: INE02ID01020,ISIN Name: RAYMOND LIFESTYLE-EQ,,,,,
2024-03-01 00:00:00,,Opening Balance,,,,0.0
2024-07-23 00:00:00,502033,CREDIT Corporate Action REARRANGEMENT,,5.0,,5.0
2024-11-27 00:00:00,,Closing Balance,,,,5.0
ISIN: INE301A01014,ISIN Name: RAYMOND LIMITED EQ,,,,,
2024-03-01 00:00:00,,Opening Balance,,,,0.0
2024-06-03 00:00:00,710854,CREDIT On Market 1208870000010189,,2.0,,2.0
2024-06-10 00:00:00,880316,CREDIT On Market 1208870000010189,,1.0,,3.0
2024-06-24 00:00:00,802849,CREDIT On Market 1208870000010189,,1.0,,4.0
2024-06-27 00:00:00,215487,CREDIT On Market 1208870000010189,,1.0,,5.0
2024-07-02 00:00:00,206740,CREDIT On Market 1208870000010189,,1.0,,6.0
2024-07-05 00:00:00,577319,CREDIT On Market 1208870000010189,,1.0,,7.0
2024-07-22 00:00:00,1047882,DEBIT On Market 1100001100021102,1211242024136.0,,2.0,5.0
2024-07-23 00:00:00,1047882,DEBIT On Market 1100001100021102,1211242024136.0,,2.0,3.0
2024-07-23 00:00:00,1047882,CREDIT On Market 1100001100021102,1211242024136.0,2.0,,5.0
2024-07-25 00:00:00,9131638,DEBIT On Market 1100001100021102,1211242024139.0,,3.0,2.0
2024-07-26 00:00:00,9131638,CREDIT On Market 1100001100021102,1211242024139.0,3.0,,5.0
2024-07-26 00:00:00,9131638,DEBIT On Market 1100001100021102,1211242024139.0,,3.0,2.0
2024-07-30 00:00:00,504203,CREDIT On Market 1208870000010189,,2.0,,4.0
2024-07-31 00:00:00,22686061,DEBIT On Market 1100001100021102,1211232024143.0,,2.0,2.0
2024-08-01 00:00:00,22686061,DEBIT On Market 1100001100021102,1211232024143.0,,2.0,0.0
2024-08-01 00:00:00,22686061,CREDIT On Market 1100001100021102,1211232024143.0,2.0,,2.0
2024-11-27 00:00:00,,Closing Balance,,,,2.0
ISIN: INE002A01018,ISIN Name: RELIANCE INDUS-EQ,,,,,
2024-03-01 00:00:00,,Opening Balance,,,,0.0
2024-06-19 00:00:00,33078542,DEBIT On Market 1100001100021102,1211232024114.0,,1.0,2.0
2024-06-20 00:00:00,33078542,DEBIT On Market 1100001100021102,1211232024114.0,,1.0,1.0
2024-06-20 00:00:00,33078542,CREDIT On Market 1100001100021102,1211232024114.0,1.0,,2.0
2024-07-02 00:00:00,206652,CREDIT On Market 1208870000010189,,1.0,,3.0
2024-07-10 00:00:00,79250065,DEBIT On Market 1100001100021102,1211232024129.0,,1.0,2.0
2024-07-11 00:00:00,79250065,CREDIT On Market 1100001100021102,1211232024129.0,1.0,,3.0
2024-07-11 00:00:00,79250065,DEBIT On Market 1100001100021102,1211232024129.0,,1.0,2.0
2024-07-18 00:00:00,94198705,DEBIT On Market 1100001100021102,1211232024134.0,,1.0,1.0
2024-07-19 00:00:00,94198705,DEBIT On Market 1100001100021102,1211232024134.0,,1.0,0.0
2024-07-19 00:00:00,94198705,CREDIT On Market 1100001100021102,1211232024134.0,1.0,,1.0
2024-07-30 00:00:00,503305,CREDIT On Market 1208870000010189,,1.0,,2.0
2024-08-20 00:00:00,280740,CREDIT On Market 1208870000010189,,1.0,,3.0
2024-09-03 00:00:00,486313,CREDIT On Market 1208870000010189,,1.0,,4.0
2024-11-01 00:00:00,801380,CREDIT Corporate Action TRANSFER_ON_LISTING_APPROVAL,,4.0,,8.0
2024-11-27 00:00:00,,Closing Balance,,,,8.0
ISIN: IN8002A01017,ISIN Name: RELIANCE LIST PEN,,,,,
2024-03-01 00:00:00,,Opening Balance,,,,0.0
2024-10-29 00:00:00,155891,CREDIT Corporate Action BONUS,,4.0,,4.0
2024-11-01 00:00:00,801380,DEBIT Corporate Action TRANSFER_ON_LISTING_APPROVAL,,,4.0,0.0
2024-11-27 00:00:00,,Closing Balance,,,,0.0
ISIN: INE114A01011,ISIN Name: SAIL EQUITY SHARES,,,,,
2024-03-01 00:00:00,,Opening Balance,,,,0.0
2024-06-12 00:00:00,745361,CREDIT On Market 1208870000010189,,5.0,,5.0
2024-08-20 00:00:00,280860,CREDIT On Market 1208870000010189,,10.0,,15.0
2024-11-27 00:00:00,,Closing Balance,,,,15.0
ISIN: INE0PQ101010,ISIN Name: SARASWATI SA-EQ,,,,,
2024-03-01 00:00:00,,Opening Balance,,,,0.0
2024-08-21 00:00:00,777808,CREDIT On Market 1208870000010189,,100.0,,100.0
2024-08-22 00:00:00,61515771,DEBIT On Market 1100001100021102,1211242024158.0,,50.0,50.0
2024-08-23 00:00:00,61515771,DEBIT On Market 1100001100021102,1211242024158.0,,50.0,0.0
2024-08-23 00:00:00,61515771,CREDIT On Market 1100001100021102,1211242024158.0,50.0,,50.0
2024-08-26 00:00:00,66886102,DEBIT On Market 1100001100021102,1211242024160.0,,50.0,0.0
2024-08-27 00:00:00,66886102,CREDIT On Market 1100001100021102,1211242024160.0,50.0,,50.0
2024-08-27 00:00:00,66886102,DEBIT On Market 1100001100021102,1211242024160.0,,50.0,0.0
2024-11-27 00:00:00,,Closing Balance,,,,0.0
ISIN: INE062A01020,ISIN Name: SBI - EQ,,,,,
2024-03-01 00:00:00,,Opening Balance,,,,0.0
2024-06-14 00:00:00,972238,CREDIT On Market 1208870000010189,,2.0,,2.0
2024-07-18 00:00:00,836072,CREDIT On Market 1208870000010189,,1.0,,3.0
2024-07-18 00:00:00,94155467,DEBIT On Market 1100001100021102,1211232024134.0,,2.0,1.0
2024-07-19 00:00:00,94155467,CREDIT On Market 1100001100021102,1211232024134.0,2.0,,3.0
2024-07-19 00:00:00,94155467,DEBIT On Market 1100001100021102,1211232024134.0,,2.0,1.0
2024-07-31 00:00:00,291687,CREDIT On Market 1208870000010189,,1.0,,2.0
2024-08-20 00:00:00,280798,CREDIT On Market 1208870000010189,,2.0,,4.0
2024-08-21 00:00:00,777771,CREDIT On Market 1208870000010189,,1.0,,5.0
2024-11-27 00:00:00,,Closing Balance,,,,5.0
ISIN: INE123W01016,ISIN Name: SBI LIFE INSURANC-EQ,,,,,
2024-03-01 00:00:00,,Opening Balance,,,,0.0
2024-04-29 00:00:00,262929,CREDIT On Market 1208870000010189,,2.0,,2.0
2024-06-05 00:00:00,1268613,CREDIT On Market 1100001100021102,1211232024104.0,2.0,,4.0
2024-06-05 00:00:00,1268613,DEBIT On Market 1100001100021102,1211232024104.0,,2.0,2.0
2024-11-27 00:00:00,,Closing Balance,,,,0.0
ISIN: INE343H01029,ISIN Name: SOLAR INDUST-EQ,,,,,
2024-03-01 00:00:00,,Opening Balance,,,,0.0
2024-06-03 00:00:00,801768,CREDIT On Market 1208870000010189,,1.0,,1.0
2024-06-18 00:00:00,651004,CREDIT On Market 1208870000010189,,1.0,,3.0
2024-07-12 00:00:00,327825,CREDIT On Market 1208870000010189,,1.0,,4.0
2024-07-19 00:00:00,98050341,CREDIT On Market 1100001100021102,1211232024135.0,1.0,,5.0
2024-07-19 00:00:00,98050341,DEBIT On Market 1100001100021102,1211232024135.0,,1.0,4.0
2024-07-25 00:00:00,9143497,DEBIT On Market 1100001100021102,1211232024139.0,,2.0,2.0
2024-07-26 00:00:00,9143497,CREDIT On Market 1100001100021102,1211232024139.0,2.0,,4.0
2024-07-26 00:00:00,9143497,DEBIT On Market 1100001100021102,1211232024139.0,,2.0,2.0
2024-07-29 00:00:00,188960,CREDIT On Market 1208870000010189,,1.0,,3.0
2024-08-02 00:00:00,27761165,DEBIT On Market 1100001100021102,1211232024145.0,,1.0,2.0
2024-08-05 00:00:00,27761165,CREDIT On Market 1100001100021102,1211232024145.0,1.0,,3.0
2024-08-05 00:00:00,27761165,DEBIT On Market 1100001100021102,1211232024145.0,,1.0,2.0
2024-08-20 00:00:00,280892,CREDIT On Market 1208870000010189,,1.0,,3.0
2024-11-27 00:00:00,,Closing Balance,,,,3.0
ISIN: INE044A01036,ISIN Name: SUN PHARMA RE.1/-,,,,,
2024-03-01 00:00:00,,Opening Balance,,,,0.0
2024-06-07 00:00:00,418802,CREDIT On Market 1208870000010189,,2.0,,2.0
2024-06-19 00:00:00,33090762,DEBIT On Market 1100001100021102,1211232024114.0,,1.0,1.0
2024-06-20 00:00:00,33090762,DEBIT On Market 1100001100021102,1211232024114.0,,1.0,0.0
2024-06-20 00:00:00,33090762,CREDIT On Market 1100001100021102,1211232024114.0,1.0,,1.0
2024-07-05 00:00:00,755112,CREDIT On Market 1208870000010189,,1.0,,2.0
2024-07-18 00:00:00,94174371,DEBIT On Market 1100001100021102,1211232024134.0,,1.0,1.0
2024-07-19 00:00:00,94174371,CREDIT On Market 1100001100021102,1211232024134.0,1.0,,2.0
2024-07-19 00:00:00,94174371,DEBIT On Market 1100001100021102,1211232024134.0,,1.0,1.0
2024-07-25 00:00:00,922270,CREDIT On Market 1208870000010189,,1.0,,2.0
2024-07-30 00:00:00,503491,CREDIT On Market 1208870000010189,,2.0,,4.0
2024-11-27 00:00:00,,Closing Balance,,,,4.0
ISIN: INE040H01021,ISIN Name: SUZLON ENERG-EQ RS 2,,,,,
2024-03-01 00:00:00,,Opening Balance,,,,0.0
2024-04-25 00:00:00,968589,CREDIT On Market 1208870000010189,,25.0,,25.0
2024-05-16 00:00:00,420131,CREDIT On Market 1208870000010189,,25.0,,50.0
2024-05-27 00:00:00,143972,CREDIT On Market 1208870000010189,,25.0,,75.0
2024-06-05 00:00:00,770763,CREDIT On Market 1208870000010189,,25.0,,100.0
2024-06-07 00:00:00,418731,CREDIT On Market 1208870000010189,,25.0,,125.0
2024-06-14 00:00:00,952590,CREDIT On Market 1208870000010189,,75.0,,200.0
2024-06-25 00:00:00,336902,CREDIT On Market 1208870000010189,,50.0,,250.0
2024-07-10 00:00:00,446394,CREDIT On Market 1208870000010189,,50.0,,300.0
2024-07-16 00:00:00,91160877,DEBIT On Market 1100001100021102,1211232024133.0,,100.0,200.0
2024-07-18 00:00:00,91160877,CREDIT On Market 1100001100021102,1211232024133.0,100.0,,300.0
2024-07-18 00:00:00,91160877,DEBIT On Market 1100001100021102,1211232024133.0,,100.0,200.0
2024-07-23 00:00:00,4720573,DEBIT On Market 1100001100021102,1211232024137.0,,100.0,100.0
2024-07-24 00:00:00,4720573,CREDIT On Market 1100001100021102,1211232024137.0,100.0,,200.0
2024-07-24 00:00:00,4720573,DEBIT On Market 1100001100021102,1211232024137.0,,100.0,100.0
2024-07-25 00:00:00,922217,CREDIT On Market 1208870000010189,,50.0,,150.0
2024-07-29 00:00:00,451430,CREDIT On Market 1208870000010189,,50.0,,200.0
2024-08-05 00:00:00,30285610,DEBIT On Market 1100001100021102,1211232024146.0,,100.0,100.0
2024-08-06 00:00:00,30285610,DEBIT On Market 1100001100021102,1211232024146.0,,100.0,0.0
2024-08-06 00:00:00,30285610,CREDIT On Market 1100001100021102,1211232024146.0,100.0,,100.0
2024-08-08 00:00:00,39789300,DEBIT On Market 1100001100021102,1211232024149.0,,50.0,50.0
2024-08-09 00:00:00,39789300,CREDIT On Market 1100001100021102,1211232024149.0,50.0,,100.0
2024-08-09 00:00:00,39789300,DEBIT On Market 1100001100021102,1211232024149.0,,50.0,50.0
2024-08-27 00:00:00,150617,CREDIT On Market 1208870000010189,,50.0,,100.0
2024-09-10 00:00:00,194704,CREDIT On Market 1208870000010189,,50.0,,150.0
2024-11-27 00:00:00,,Closing Balance,,,,150.0
ISIN: INE151A01013,ISIN Name: TATA  COMM EQ,,,,,
2024-03-01 00:00:00,,Opening Balance,,,,0.0
2024-04-29 00:00:00,262960,CREDIT On Market 1208870000010189,,2.0,,4.0
2024-05-06 00:00:00,813808,CREDIT On Market 1208870000010189,,2.0,,6.0
2024-06-05 00:00:00,1268616,DEBIT On Market 1100001100021102,1211232024104.0,,3.0,3.0
2024-06-05 00:00:00,1268616,CREDIT On Market 1100001100021102,1211232024104.0,3.0,,6.0
2024-11-27 00:00:00,,Closing Balance,,,,3.0
ISIN: INE092A01019,ISIN Name: TATA CHEMICALS EQ,,,,,
2024-03-01 00:00:00,,Opening Balance,,,,0.0
2024-04-10 00:00:00,408900,CREDIT On Market 1208870000010189,,2.0,,2.0
2024-04-16 00:00:00,712428,CREDIT On Market 1208870000010189,,2.0,,4.0
2024-06-05 00:00:00,1268609,CREDIT On Market 1100001100021102,1211232024104.0,3.0,,7.0
2024-06-05 00:00:00,1268609,DEBIT On Market 1100001100021102,1211232024104.0,,3.0,4.0
2024-06-07 00:00:00,419032,CREDIT On Market 1208870000010189,,1.0,,5.0
2024-11-27 00:00:00,,Closing Balance,,,,2.0
ISIN: INE467B01029,ISIN Name: TATA CONSULTANCY-1/-,,,,,
2024-03-01 00:00:00,,Opening Balance,,,,0.0
2024-03-20 00:00:00,597656,CREDIT On Market 1208870000010189,,1.0,,1.0
2024-03-27 00:00:00,774964,CREDIT On Market 1208870000010189,,1.0,,2.0
2024-06-04 00:00:00,99524701,DEBIT On Market 1100001100021102,1211232024104.0,,2.0,0.0
2024-06-04 00:00:00,193067,CREDIT On Market 1208870000010189,,3.0,,3.0
2024-06-05 00:00:00,99524701,CREDIT On Market 1100001100021102,1211232024104.0,2.0,,5.0
2024-06-05 00:00:00,99524701,DEBIT On Market 1100001100021102,1211232024104.0,,2.0,3.0
2024-06-18 00:00:00,27606403,DEBIT On Market 1100001100021102,1211232024113.0,,1.0,2.0
2024-06-19 00:00:00,27606403,DEBIT On Market 1100001100021102,1211232024113.0,,1.0,1.0
2024-06-19 00:00:00,27606403,CREDIT On Market 1100001100021102,1211232024113.0,1.0,,2.0
2024-07-10 00:00:00,79983649,DEBIT On Market 1100001100021102,1211232024129.0,,1.0,1.0
2024-07-11 00:00:00,79983649,CREDIT On Market 1100001100021102,1211232024129.0,1.0,,2.0
2024-07-11 00:00:00,79983649,DEBIT On Market 1100001100021102,1211232024129.0,,1.0,1.0
2024-07-30 00:00:00,504565,CREDIT On Market 1208870000010189,,1.0,,2.0
2024-11-27 00:00:00,,Closing Balance,,,,2.0
ISIN: INE155A01022,ISIN Name: TATA MOTORS-EQ RS2/-,,,,,
2024-03-01 00:00:00,,Opening Balance,,,,0.0
2024-03-27 00:00:00,317573,CREDIT On Market 1208870000010189,,2.0,,2.0
2024-04-25 00:00:00,805380,CREDIT On Market 1208870000010189,,1.0,,3.0
2024-05-16 00:00:00,821208,CREDIT On Market 1208870000010189,,2.0,,5.0
2024-05-24 00:00:00,281847,CREDIT On Market 1208870000010189,,3.0,,8.0
2024-06-05 00:00:00,1268620,CREDIT On Market 1100001100021102,1211232024104.0,4.0,,12.0
2024-06-05 00:00:00,1268620,DEBIT On Market 1100001100021102,1211232024104.0,,4.0,8.0
2024-07-09 00:00:00,157636,CREDIT On Market 1208870000010189,,2.0,,10.0
2024-07-10 00:00:00,79255135,DEBIT On Market 1100001100021102,1211232024129.0,,3.0,7.0
2024-07-11 00:00:00,79255135,DEBIT On Market 1100001100021102,1211232024129.0,,3.0,4.0
2024-07-11 00:00:00,79255135,CREDIT On Market 1100001100021102,1211232024129.0,3.0,,7.0
2024-07-26 00:00:00,878073,CREDIT On Market 1208870000010189,,2.0,,9.0
2024-11-27 00:00:00,,Closing Balance,,,,5.0
ISIN: INE245A01021,ISIN Name: TATA POWER -EQ 1/-,,,,,
2024-03-01 00:00:00,,Opening Balance,,,,0.0
2024-04-22 00:00:00,771015,CREDIT On Market 1208870000010189,,3.0,,3.0
2024-07-10 00:00:00,446514,CREDIT On Market 1208870000010189,,2.0,,5.0
2024-07-10 00:00:00,79186980,DEBIT On Market 1100001100021102,1211232024129.0,,3.0,2.0
2024-07-11 00:00:00,79186980,CREDIT On Market 1100001100021102,1211232024129.0,3.0,,5.0
2024-07-11 00:00:00,79186980,DEBIT On Market 1100001100021102,1211232024129.0,,3.0,2.0
2024-07-18 00:00:00,836377,CREDIT On Market 1208870000010189,,3.0,,5.0
2024-07-23 00:00:00,978295,CREDIT On Market 1208870000010189,,3.0,,8.0
2024-07-25 00:00:00,9165439,DEBIT On Market 1100001100021102,1211232024139.0,,3.0,5.0
2024-07-26 00:00:00,9165439,DEBIT On Market 1100001100021102,1211232024139.0,,3.0,2.0
2024-07-26 00:00:00,9165439,CREDIT On Market 1100001100021102,1211232024139.0,3.0,,5.0
ISIN: INE081A01020,ISIN Name: TATA STEEL-EQ1/-,,,,,
2024-03-01 00:00:00,,Opening Balance,,,,0.0
2024-03-28 00:00:00,872045,CREDIT On Market 1208870000010189,,2.0,,2.0
2024-04-19 00:00:00,288101,CREDIT On Market 1208870000010189,,3.0,,5.0
2024-06-03 00:00:00,396484,CREDIT On Market 1208870000010189,,4.0,,9.0
2024-06-07 00:00:00,418954,CREDIT On Market 1208870000010189,,3.0,,12.0
2024-06-18 00:00:00,493328,CREDIT On Market 1208870000010189,,3.0,,15.0
2024-06-26 00:00:00,46700625,DEBIT On Market 1100001100021102,1211232024119.0,,5.0,10.0
2024-06-27 00:00:00,46700625,DEBIT On Market 1100001100021102,1211232024119.0,,5.0,5.0
2024-06-27 00:00:00,46700625,CREDIT On Market 1100001100021102,1211232024119.0,5.0,,10.0
2024-07-04 00:00:00,65151105,DEBIT On Market 1100001100021102,1211232024125.0,,5.0,5.0
2024-07-05 00:00:00,65151105,DEBIT On Market 1100001100021102,1211232024125.0,,5.0,0.0
2024-07-05 00:00:00,65151105,CREDIT On Market 1100001100021102,1211232024125.0,5.0,,5.0
2024-07-10 00:00:00,446426,CREDIT On Market 1208870000010189,,5.0,,10.0
2024-07-12 00:00:00,327784,CREDIT On Market 1208870000010189,,10.0,,20.0
2024-07-18 00:00:00,836133,CREDIT On Market 1208870000010189,,10.0,,30.0
2024-07-19 00:00:00,98459198,DEBIT On Market 1100001100021102,1211232024135.0,,15.0,15.0
2024-07-22 00:00:00,98459198,DEBIT On Market 1100001100021102,1211232024135.0,,15.0,0.0
2024-07-22 00:00:00,98459198,CREDIT On Market 1100001100021102,1211232024135.0,15.0,,15.0
2024-07-22 00:00:00,1318939,DEBIT On Market 1100001100021102,1211232024136.0,,5.0,10.0
2024-07-23 00:00:00,1318939,CREDIT On Market 1100001100021102,1211232024136.0,5.0,,15.0
2024-07-23 00:00:00,1318939,DEBIT On Market 1100001100021102,1211232024136.0,,5.0,10.0
2024-07-31 00:00:00,291737,CREDIT On Market 1208870000010189,,10.0,,20.0
2024-11-27 00:00:00,,Closing Balance,,,,20.0
ISIN: INE142M01025,ISIN Name: TATA TECHNOLOG-EQ2/-,,,,,
2024-03-01 00:00:00,,Opening Balance,,,,0.0
2024-07-19 00:00:00,981631,CREDIT On Market 1208870000010189,,2.0,,2.0
2024-11-27 00:00:00,,Closing Balance,,,,2.0
ISIN: INE669C01036,ISIN Name: TECH MAHINDRA-EQ,,,,,
2024-03-01 00:00:00,,Opening Balance,,,,0.0
2024-06-04 00:00:00,193119,CREDIT On Market 1208870000010189,,2.0,,2.0
2024-06-14 00:00:00,138028,CREDIT On Market 1208870000010189,,2.0,,4.0
2024-07-01 00:00:00,403985,CREDIT On Market 1208870000010189,,1.0,,5.0
2024-07-26 00:00:00,13531472,DEBIT On Market 1100001100021102,1211232024140.0,,2.0,3.0
2024-07-29 00:00:00,13531472,DEBIT On Market 1100001100021102,1211232024140.0,,2.0,1.0
2024-07-29 00:00:00,13531472,CREDIT On Market 1100001100021102,1211232024140.0,2.0,,3.0
2024-11-27 00:00:00,,Closing Balance,,,,3.0
ISIN: INE280A01028,ISIN Name: TITAN COMPANY-EQ 1/-,,,,,
2024-03-01 00:00:00,,Opening Balance,,,,0.0
2024-06-07 00:00:00,419303,CREDIT On Market 1208870000010189,,3.0,,3.0
2024-07-08 00:00:00,71260846,DEBIT On Market 1100001100021102,1211232024127.0,,2.0,1.0
2024-07-09 00:00:00,71260846,DEBIT On Market 1100001100021102,1211232024127.0,,2.0,-1.0
2024-07-09 00:00:00,71260846,CREDIT On Market 1100001100021102,1211232024127.0,2.0,,1.0
2024-07-10 00:00:00,446577,CREDIT On Market 1208870000010189,,1.0,,2.0
2024-07-15 00:00:00,89106514,DEBIT On Market 1100001100021102,1211232024132.0,,1.0,1.0
2024-07-16 00:00:00,89106514,DEBIT On Market 1100001100021102,1211232024132.0,,1.0,0.0
2024-07-16 00:00:00,89106514,CREDIT On Market 1100001100021102,1211232024132.0,1.0,,1.0
2024-07-30 00:00:00,504122,CREDIT On Market 1208870000010189,,2.0,,3.0
2024-11-27 00:00:00,,Closing Balance,,,,3.0
ISIN: INE494B01023,ISIN Name: TVS MOTOR RE 1/-,,,,,
2024-03-01 00:00:00,,Opening Balance,,,,0.0
2024-07-24 00:00:00,948181,CREDIT On Market 1208870000010189,,2.0,,2.0
2024-11-27 00:00:00,,Closing Balance,,,,2.0
ISIN: INE669E01016,ISIN Name: VODAFONE IDEA-EQ,,,,,
2024-03-01 00:00:00,,Opening Balance,,,,0.0
2024-05-27 00:00:00,768868,CREDIT On Market 1208870000010189,,25.0,,75.0
2024-06-04 00:00:00,193151,CREDIT On Market 1208870000010189,,25.0,,100.0
2024-06-11 00:00:00,264914,CREDIT On Market 1208870000010189,,25.0,,125.0
2024-06-14 00:00:00,741251,CREDIT On Market 1208870000010189,,75.0,,200.0
2024-07-19 00:00:00,869484,CREDIT On Market 1208870000010189,,50.0,,250.0
2024-07-23 00:00:00,4488543,DEBIT On Market 1100001100021102,1211232024137.0,,100.0,150.0
2024-07-24 00:00:00,4488543,DEBIT On Market 1100001100021102,1211232024137.0,,100.0,50.0
2024-07-24 00:00:00,4488543,CREDIT On Market 1100001100021102,1211232024137.0,100.0,,150.0
2024-07-31 00:00:00,22000473,DEBIT On Market 1100001100021102,1211232024143.0,,50.0,100.0
2024-08-01 00:00:00,22000473,DEBIT On Market 1100001100021102,1211232024143.0,,50.0,50.0
2024-08-01 00:00:00,22000473,CREDIT On Market 1100001100021102,1211232024143.0,50.0,,100.0
2024-08-14 00:00:00,850549,CREDIT On Market 1208870000010189,,50.0,,150.0
2024-08-29 00:00:00,744452,CREDIT On Market 1208870000010189,,150.0,,300.0
2024-09-06 00:00:00,91193260,DEBIT On Market 1100001100021102,1211232024169.0,,200.0,100.0
2024-09-09 00:00:00,91193260,DEBIT On Market 1100001100021102,1211232024169.0,,200.0,-100.0
2024-09-09 00:00:00,91193260,CREDIT On Market 1100001100021102,1211232024169.0,200.0,,100.0
2024-11-27 00:00:00,,Closing Balance,,,,100.0
ISIN: INE075A01022,ISIN Name: WIPRO EQUITY - RS 2,,,,,
2024-03-01 00:00:00,,Opening Balance,,,,0.0
2024-06-18 00:00:00,874278,CREDIT On Market 1208870000010189,,5.0,,5.0
2024-07-23 00:00:00,4400601,DEBIT On Market 1100001100021102,1211232024137.0,,3.0,2.0
2024-07-24 00:00:00,4400601,CREDIT On Market 1100001100021102,1211232024137.0,3.0,,5.0
2024-07-24 00:00:00,4400601,DEBIT On Market 1100001100021102,1211232024137.0,,3.0,2.0
2024-08-02 00:00:00,871451,CREDIT On Market 1208870000010189,,2.0,,4.0
2024-11-27 00:00:00,,Closing Balance,,,,4.0
ISIN: INE528G01035,ISIN Name: YES BANK LTD-EQ2/-,,,,,
2024-03-01 00:00:00,,Opening Balance,,,,0.0
2024-04-03 00:00:00,401127,CREDIT On Market 1208870000010189,,100.0,,100.0
2024-05-31 00:00:00,91604826,DEBIT On Market 1100001100021102,1211232024102.0,,75.0,25.0
2024-05-31 00:00:00,91605000,CREDIT On Market 1100001100021102,1211232024102.0,6.0,,31.0
2024-05-31 00:00:00,91605000,DEBIT On Market 1100001100021102,1211232024102.0,,25.0,6.0
2024-06-03 00:00:00,91604826,CREDIT On Market 1100001100021102,1211232024102.0,75.0,,81.0
2024-06-03 00:00:00,91604826,DEBIT On Market 1100001100021102,1211232024102.0,,75.0,6.0
2024-06-03 00:00:00,91605000,CREDIT On Market 1100001100021102,1211232024102.0,19.0,,25.0
2024-06-03 00:00:00,91605000,DEBIT On Market 1100001100021102,1211232024102.0,,19.0,6.0
2024-06-04 00:00:00,193092,CREDIT On Market 1208870000010189,,4.0,,10.0
2024-07-10 00:00:00,446610,CREDIT On Market 1208870000010189,,10.0,,20.0
2024-07-15 00:00:00,88633260,DEBIT On Market 1100001100021102,1211232024132.0,,5.0,15.0
2024-07-15 00:00:00,88635982,DEBIT On Market 1100001100021102,1211232024132.0,,10.0,5.0
2024-07-16 00:00:00,88633260,DEBIT On Market 1100001100021102,1211232024132.0,,5.0,0.0
2024-07-16 00:00:00,88633260,CREDIT On Market 1100001100021102,1211232024132.0,5.0,,5.0
2024-07-16 00:00:00,88635982,DEBIT On Market 1100001100021102,1211232024132.0,,10.0,-5.0
2024-07-16 00:00:00,88635982,CREDIT On Market 1100001100021102,1211232024132.0,10.0,,5.0
2024-07-23 00:00:00,978364,CREDIT On Market 1208870000010189,,5.0,,10.0
2024-11-27 00:00:00,,Closing Balance,,,,10.0
ISIN: INE520A01027,ISIN Name: ZENSAR TECHNO-EQ2/-,,,,,
2024-03-01 00:00:00,,Opening Balance,,,,0.0
2024-04-02 00:00:00,173062,CREDIT On Market 1208870000010189,,5.0,,5.0
2024-06-05 00:00:00,1268629,CREDIT On Market 1100001100021102,1211232024104.0,3.0,,8.0
2024-06-05 00:00:00,1268629,DEBIT On Market 1100001100021102,1211232024104.0,,3.0,5.0
2024-06-11 00:00:00,531623,CREDIT On Market 1208870000010189,,3.0,,8.0
2024-06-14 00:00:00,141342,CREDIT On Market 1208870000010189,,5.0,,13.0
2024-07-18 00:00:00,836441,CREDIT On Market 1208870000010189,,5.0,,18.0
2024-07-19 00:00:00,98697690,DEBIT On Market 1100001100021102,1211232024135.0,,5.0,13.0
2024-07-22 00:00:00,98697690,CREDIT On Market 1100001100021102,1211232024135.0,5.0,,18.0
2024-07-30 00:00:00,504651,CREDIT On Market 1208870000010189,,5.0,,18.0
2024-08-02 00:00:00,27789076,DEBIT On Market 1100001100021102,1211232024145.0,,5.0,13.0
2024-08-05 00:00:00,27789076,DEBIT On Market 1100001100021102,1211232024145.0,,5.0,8.0
2024-08-05 00:00:00,27789076,CREDIT On Market 1100001100021102,1211232024145.0,5.0,,13.0
2024-11-27 00:00:00,,Closing Balance,,,,10.0
ISIN: INE758T01015,ISIN Name: ZOMATO LIMITED-EQ,,,,,
2024-03-01 00:00:00,,Opening Balance,,,,0.0
2024-03-27 00:00:00,451345,CREDIT On Market 1208870000010189,,5.0,,5.0
2024-04-30 00:00:00,154656,CREDIT On Market 1208870000010189,,5.0,,10.0
2024-06-03 00:00:00,383582,CREDIT On Market 1208870000010189,,20.0,,30.0
2024-06-03 00:00:00,97399271,DEBIT On Market 1100001100021102,1211232024103.0,,20.0,10.0
2024-06-04 00:00:00,97399271,CREDIT On Market 1100001100021102,1211232024103.0,20.0,,30.0
2024-06-05 00:00:00,1268633,DEBIT On Market 1100001100021102,1211232024104.0,,5.0,25.0
2024-06-05 00:00:00,1268633,CREDIT On Market 1100001100021102,1211232024104.0,5.0,,30.0
2024-06-07 00:00:00,419720,CREDIT On Market 1208870000010189,,5.0,,35.0
2024-06-19 00:00:00,381333,CREDIT On Market 1208870000010189,,10.0,,45.0
2024-07-05 00:00:00,107704,CREDIT On Market 1208870000010189,,5.0,,50.0
2024-07-10 00:00:00,446644,CREDIT On Market 1208870000010189,,10.0,,60.0
2024-08-05 00:00:00,857999,CREDIT On Market 1208870000010189,,5.0,,65.0
2024-08-09 00:00:00,41406112,DEBIT On Market 1100001100021102,1211232024150.0,,10.0,55.0
2024-08-12 00:00:00,41406112,DEBIT On Market 1100001100021102,1211232024150.0,,10.0,45.0
2024-08-12 00:00:00,41406112,CREDIT On Market 1100001100021102,1211232024150.0,10.0,,55.0
2024-08-12 00:00:00,43702667,DEBIT On Market 1100001100021102,1211232024151.0,,10.0,45.0
2024-08-13 00:00:00,43702667,DEBIT On Market 1100001100021102,1211232024151.0,,10.0,35.0
2024-08-13 00:00:00,43702667,CREDIT On Market 1100001100021102,1211232024151.0,10.0,,45.0
2024-08-21 00:00:00,777857,CREDIT On Market 1208870000010189,,10.0,,55.0
2024-11-27 00:00:00,,Closing Balance,,,,50.0
